,VidInfo,Action,StartFrame,EndFrame,Len
1,vid1,goal,583,654,71
2,vid1,pass,1051,1096,45
3,vid1,pass,1910,1944,34
4,vid1,pass,2748,2796,48
5,vid1,save,2972,2998,26
6,vid1,pass,3329,3400,71
7,vid1,pass,3400,3440,40
8,vid1,pass,3484,3531,47
10,vid1,pass,3656,3689,33
12,vid1,pass,3765,3813,48
13,vid1,pass,3805,3842,37
14,vid1,pass,3901,3935,34
15,vid1,pass,3939,3972,33
16,vid1,goal,4053,4098,45
17,vid1,goal,4069,4155,86
18,vid1,goal,4710,4747,37
19,vid1,pass,4797,4841,44
20,vid1,pass,5338,5387,49
21,vid1,pass,5436,5476,40
22,vid1,pass,5595,5626,31
23,vid1,pass,5655,5698,43
24,vid1,goal,5865,5888,23
25,vid1,pass,6092,6120,28
27,vid1,pass,6760,6800,40
28,vid1,pass,6795,6857,62
29,vid1,pass,6926,6965,39
30,vid1,pass,7103,7157,54
31,vid1,pass,7456,7501,45
32,vid1,pass,7639,7677,38
33,vid1,pass,7704,7745,41
34,vid1,pass,7989,8029,40
35,vid1,pass,8121,8164,43
36,vid1,pass,8199,8238,39
37,vid1,tackle,8375,8393,18
39,vid1,save,8794,8836,42
41,vid1,pass,9019,9095,76
42,vid1,pass,9096,9155,59
43,vid1,pass,9965,9997,32
44,vid1,pass,9996,10044,48
45,vid1,pass,10637,10678,41
46,vid1,pass,12124,12159,35
47,vid1,pass,12188,12222,34
48,vid1,pass,12509,12566,57
49,vid1,pass,12613,12647,34
50,vid1,pass,13046,13087,41
51,vid1,pass,13179,13218,39
52,vid1,goal,13463,13504,41
54,vid1,pass,13837,13881,44
55,vid1,pass,14577,14619,42
56,vid1,pass,15360,15420,60
57,vid1,tackle,16215,16236,21
58,vid1,pass,16287,16313,26
59,vid1,pass,17364,17401,37
60,vid1,pass,17549,17593,44
61,vid1,pass,17652,17689,37
62,vid1,pass,18440,18478,38
63,vid1,save,18473,18524,51
64,vid1,pass,18691,18727,36
65,vid1,goal,21192,21224,32
66,vid1,pass,21344,21390,46
67,vid1,pass,22154,22186,32
68,vid1,pass,23184,23268,84
69,vid1,pass,23590,23636,46
71,vid1,pass,23966,24003,37
73,vid1,pass,25661,25707,46
74,vid1,pass,28472,28530,58
75,vid1,tackle,28576,28613,37
76,vid1,pass,29931,29998,67
77,vid1,pass,30929,30967,38
78,vid1,pass,30959,30989,30
79,vid1,pass,32698,32769,71
80,vid1,tackle,32849,32872,23
81,vid1,tackle,32870,32897,27
83,vid1,save,34804,34824,20
84,vid1,save,35401,35461,60
85,vid1,pass,35508,35580,72
86,vid1,pass,36517,36570,53
87,vid1,save,39842,39873,31
88,vid1,pass,40539,40590,51
89,vid1,tackle,41309,41335,26
90,vid1,pass,41367,41392,25
91,vid1,pass,44566,44611,45
92,vid1,pass,44692,44742,50
93,vid1,goal,46630,46683,53
95,vid1,pass,46943,46986,43
96,vid1,goal,47742,47778,36
98,vid1,goal,49348,49392,44
99,vid1,goal,50773,50791,18
100,vid1,pass,50966,50996,30
101,vid1,goal,51284,51329,45
102,vid1,goal,51792,51820,28
103,vid1,pass,52202,52232,30
104,vid1,tackle,54222,54246,24
105,vid1,pass,54654,54700,46
106,vid1,goal,56268,56286,18
107,vid2,goal,680,729,49
108,vid2,pass,799,849,50
109,vid2,pass,843,872,29
110,vid2,tackle,915,955,40
111,vid2,pass,1359,1392,33
112,vid2,goal,2205,2237,32
113,vid2,pass,2814,2884,70
114,vid2,pass,3456,3516,60
115,vid2,pass,8799,8833,34
117,vid2,pass,9001,9029,28
118,vid2,pass,10126,10184,58
119,vid2,pass,13275,13315,40
120,vid2,pass,13968,14021,53
121,vid2,pass,14048,14089,41
123,vid2,pass,14150,14181,31
125,vid2,pass,15437,15487,50
126,vid2,tackle,15547,15563,16
128,vid2,pass,15611,15636,25
129,vid2,pass,15849,15896,47
131,vid2,pass,16013,16073,60
132,vid2,pass,16177,16219,42
133,vid2,tackle,17003,17041,38
134,vid2,tackle,17047,17085,38
135,vid2,pass,17230,17267,37
136,vid2,pass,17339,17393,54
137,vid2,tackle,17663,17704,41
139,vid2,tackle,18234,18273,39
140,vid2,goal,18300,18334,34
141,vid2,pass,19153,19183,30
142,vid2,pass,20438,20486,48
143,vid2,pass,22652,22692,40
144,vid2,goal,23346,23382,36
145,vid2,pass,23636,23678,42
146,vid2,pass,26292,26340,48
147,vid2,pass,27721,27786,65
148,vid2,tackle,31962,31982,20
149,vid2,pass,35085,35119,34
150,vid2,pass,35176,35223,47
151,vid2,pass,37173,37218,45
152,vid2,pass,37231,37299,68
153,vid2,tackle,37231,37248,17
154,vid2,tackle,37278,37299,21
155,vid2,pass,37308,37358,50
156,vid2,pass,40812,40857,45
157,vid2,pass,40886,40928,42
158,vid2,pass,40986,41035,49
159,vid2,pass,41074,41109,35
160,vid2,pass,41523,41578,55
161,vid2,pass,41595,41645,50
162,vid2,pass,42697,42741,44
163,vid2,pass,42778,42851,73
164,vid2,save,43366,43398,32
165,vid2,goal,43446,43478,32
166,vid2,pass,43694,43744,50
167,vid2,tackle,44179,44203,24
168,vid2,tackle,44232,44250,18
169,vid2,pass,44305,44390,85
170,vid2,pass,44682,44747,65
171,vid2,pass,44604,44649,45
172,vid2,pass,46597,46624,27
173,vid2,pass,46720,46760,40
174,vid2,tackle,46939,46981,42
175,vid2,tackle,49620,49645,25
176,vid2,pass,53330,53395,65
177,vid2,pass,58546,58580,34
178,vid2,pass,58587,58643,56
179,vid2,goal,58638,58673,35
180,vid2,pass,59028,59090,62
181,vid2,pass,59283,59311,28
182,vid2,save,59323,59349,26
183,vid2,tackle,61443,61465,22
184,vid2,save,61450,61487,37
185,vid2,pass,64167,64206,39
186,vid2,tackle,65602,65627,25
187,vid2,tackle,67743,67770,27
188,vid2,pass,68110,68141,31
189,vid2,tackle,68763,68789,26
190,vid2,pass,69363,69396,33
192,vid2,pass,70416,70471,55
193,vid2,pass,70728,70763,35
194,vid2,pass,70766,70816,50
195,vid2,pass,71908,71948,40
196,vid2,pass,72037,72086,49
197,vid2,pass,72101,72146,45
198,vid2,pass,72973,73013,40
199,vid2,goal,73045,73085,40
200,vid2,pass,73304,73352,48
201,vid2,pass,73379,73440,61
202,vid2,pass,73435,73474,39
203,vid2,pass,73482,73540,58
204,vid2,pass,73613,73654,41
205,vid2,pass,74045,74080,35
207,vid2,pass,75000,75038,38
208,vid2,tackle,75049,75083,34
209,vid2,pass,75557,75579,22
210,vid2,save,75582,75613,31
211,vid2,pass,75827,75862,35
212,vid2,pass,76067,76113,46
214,vid2,tackle,77028,77048,20
215,vid2,pass,77083,77128,45
216,vid2,pass,77416,77455,39
217,vid2,pass,78188,78205,17
218,vid2,goal,78833,78884,51
219,vid2,pass,78995,79046,51
220,vid2,pass,79102,79145,43
221,vid2,pass,79149,79171,22
222,vid2,pass,79812,79836,24
223,vid2,goal,79864,79892,28
224,vid2,pass,80315,80366,51
225,vid2,pass,80449,80502,53
226,vid2,save,80691,80716,25
227,vid2,goal,80806,80850,44
228,vid2,pass,82041,82082,41
229,vid2,pass,82088,82128,40
230,vid2,pass,82551,82606,55
231,vid2,save,82621,82641,20
232,vid2,pass,83364,83409,45
234,vid2,pass,84647,84670,23
235,vid2,pass,85139,85177,38
236,vid2,pass,85226,85271,45
237,vid2,goal,85262,85292,30
238,vid2,pass,85599,85640,41
239,vid2,pass,85795,85838,43
240,vid2,pass,87382,87422,40
242,vid2,pass,87976,88003,27
243,vid2,tackle,90589,90608,19
244,vid2,tackle,91564,91587,23
245,vid2,tackle,91657,91679,22
246,vid2,pass,92614,92646,32
247,vid2,pass,93693,93728,35
248,vid2,tackle,94402,94432,30
249,vid2,pass,94652,94687,35
250,vid2,tackle,95495,95527,32
251,vid2,goal,96501,96568,67
252,vid2,pass,97015,97060,45
253,vid2,pass,97258,97306,48
254,vid2,pass,97624,97664,40
255,vid2,pass,97679,97725,46
256,vid2,pass,97740,97791,51
257,vid2,pass,98534,98564,30
258,vid2,pass,99687,99727,40
259,vid2,goal,99778,99813,35
260,vid2,goal,100340,100379,39
261,vid3,pass,115,159,44
262,vid3,pass,154,193,39
263,vid3,pass,640,665,25
264,vid3,pass,713,741,28
265,vid3,pass,1729,1768,39
266,vid3,pass,2134,2178,44
267,vid3,pass,2208,2232,24
268,vid3,tackle,2353,2378,25
269,vid3,pass,2782,2821,39
270,vid3,pass,2816,2859,43
271,vid3,save,2856,2892,36
272,vid3,save,2990,3006,16
273,vid3,save,3682,3704,22
274,vid3,save,3833,3856,23
275,vid3,goal,8752,8805,53
276,vid3,pass,11958,11995,37
277,vid3,tackle,12498,12531,33
278,vid3,pass,12550,12581,31
279,vid3,save,12581,12617,36
280,vid3,pass,19867,19912,45
281,vid3,tackle,22105,22128,23
282,vid3,goal,22143,22181,38
283,vid3,pass,22606,22654,48
284,vid3,pass,22738,22786,48
285,vid3,pass,22801,22844,43
286,vid3,pass,24053,24104,51
287,vid3,save,25585,25609,24
288,vid3,goal,25671,25698,27
289,vid3,pass,25873,25927,54
290,vid3,tackle,27581,27613,32
291,vid3,pass,29473,29530,57
292,vid3,save,33118,33160,42
293,vid3,pass,33557,33608,51
295,vid3,goal,34935,34974,39
296,vid3,pass,35068,35112,44
297,vid3,pass,35107,35182,75
298,vid3,pass,36720,36766,46
299,vid3,pass,43248,43314,66
300,vid3,pass,43488,43533,45
301,vid3,pass,43546,43567,21
302,vid3,goal,43562,43600,38
304,vid3,pass,44108,44137,29
305,vid3,goal,45449,45484,35
306,vid3,pass,45759,45810,51
307,vid3,goal,46314,46358,44
308,vid3,pass,46615,46681,66
309,vid3,pass,48305,48366,61
310,vid3,pass,48418,48465,47
311,vid3,pass,48712,48750,38
312,vid3,save,48752,48770,18
313,vid3,goal,49002,49032,30
314,vid3,pass,50271,50316,45
315,vid3,pass,50261,50282,21
316,vid3,tackle,50621,50669,48
317,vid3,goal,52123,52173,50
318,vid3,goal,53439,53476,37
319,vid3,pass,53809,53875,66
320,vid3,save,54256,54280,24
321,vid3,pass,55341,55388,47
322,vid3,pass,55976,56022,46
323,vid3,tackle,58690,58728,38
324,vid3,pass,58728,58787,59
326,vid3,goal,59656,59697,41
327,vid3,pass,59839,59897,58
328,vid3,pass,60611,60650,39
330,vid3,pass,64775,64814,39
331,vid3,save,64809,64830,21
332,vid3,goal,66218,66258,40
333,vid3,pass,66416,66485,69
334,vid3,goal,68497,68536,39
335,vid3,save,69038,69067,29
336,vid3,pass,72124,72184,60
337,vid3,pass,74127,74167,40
338,vid3,pass,74176,74225,49
339,vid3,goal,74968,75012,44
340,vid3,pass,75163,75206,43
341,vid3,save,76007,76028,21
342,vid3,goal,78647,78679,32
343,vid3,pass,80374,80410,36
344,vid3,goal,80909,80939,30
345,vid3,pass,81276,81351,75
347,vid3,tackle,85074,85095,21
348,vid3,goal,86735,86808,73
349,vid3,goal,87238,87265,27
350,vid3,pass,87390,87444,54
352,vid3,pass,87555,87606,51
353,vid3,pass,87601,87633,32
354,vid3,pass,88659,88703,44
355,vid3,save,88726,88754,28
356,vid3,tackle,94069,94091,22
357,vid3,pass,94213,94255,42
358,vid3,goal,94437,94467,30
359,vid3,pass,94672,94735,63
360,vid3,goal,96548,96578,30
361,vid3,pass,96788,96823,35
362,vid3,pass,97828,97854,26
363,vid3,goal,100075,100107,32
366,vid4,pass,330,390,60
367,vid4,pass,420,477,57
368,vid4,pass,685,748,63
369,vid4,pass,871,921,50
370,vid4,pass,966,1026,60
371,vid4,pass,1306,1381,75
374,vid4,goal,1831,1916,85
376,vid4,pass,2596,2687,91
377,vid4,pass,2692,2732,40
378,vid4,goal,2990,3038,48
381,vid4,pass,3278,3333,55
382,vid4,pass,3458,3518,60
383,vid4,pass,3508,3593,85
384,vid4,pass,3638,3733,95
385,vid4,pass,3728,3768,40
386,vid4,pass,3993,4028,35
387,vid4,pass,4103,4173,70
388,vid4,pass,4477,4536,59
389,vid4,pass,5047,5082,35
390,vid4,goal,5572,5617,45
392,vid4,pass,8627,8712,85
394,vid4,pass,9404,9458,54
396,vid4,pass,9544,9584,40
397,vid4,pass,9609,9654,45
398,vid4,pass,10089,10137,48
399,vid4,pass,10162,10205,43
400,vid4,pass,10194,10253,59
402,vid4,tackle,10830,10865,35
403,vid4,pass,11288,11348,60
404,vid4,pass,11482,11508,26
405,vid4,pass,11607,11656,49
406,vid4,pass,11876,11927,51
407,vid4,pass,11926,11974,48
408,vid4,tackle,12209,12235,26
411,vid4,pass,13038,13088,50
412,vid4,pass,13767,13809,42
413,vid4,pass,14112,14147,35
415,vid4,pass,14630,14676,46
416,vid4,pass,14780,14832,52
417,vid4,pass,14883,14920,37
418,vid4,pass,15107,15148,41
419,vid4,tackle,15261,15293,32
420,vid4,pass,15465,15500,35
421,vid4,save,15650,15696,46
422,vid4,pass,16480,16519,39
423,vid4,pass,16512,16559,47
424,vid4,pass,16614,16644,30
425,vid4,pass,16873,16913,40
426,vid4,pass,16933,16978,45
427,vid4,tackle,16999,17023,24
428,vid4,pass,17181,17232,51
429,vid4,pass,17262,17316,54
430,vid4,pass,17666,17735,69
432,vid4,tackle,18651,18677,26
433,vid4,pass,19311,19362,51
434,vid4,pass,19682,19750,68
435,vid4,pass,19742,19780,38
436,vid4,pass,19782,19855,73
437,vid4,pass,19845,19891,46
438,vid4,pass,19887,19985,98
439,vid4,tackle,20003,20031,28
440,vid4,tackle,20060,20094,34
441,vid4,pass,20119,20145,26
442,vid4,save,20175,20195,20
443,vid4,pass,20335,20379,44
444,vid4,pass,20399,20450,51
445,vid4,pass,20842,20885,43
446,vid4,pass,20966,21006,40
447,vid4,pass,21516,21574,58
448,vid4,pass,21599,21634,35
449,vid4,pass,22058,22095,37
450,vid4,pass,22552,22600,48
451,vid4,pass,22621,22676,55
452,vid4,pass,22701,22736,35
453,vid4,pass,23004,23049,45
454,vid4,pass,23144,23194,50
455,vid4,tackle,23339,23364,25
456,vid4,pass,23371,23412,41
457,vid4,pass,23478,23526,48
458,vid4,pass,23519,23599,80
459,vid4,pass,24275,24325,50
460,vid4,save,24325,24355,30
461,vid4,pass,24522,24565,43
462,vid4,tackle,24607,24629,22
463,vid4,pass,24660,24729,69
464,vid4,pass,24730,24770,40
465,vid4,pass,25091,25131,40
466,vid4,tackle,25127,25172,45
468,vid4,pass,27502,27535,33
469,vid4,pass,27582,27652,70
470,vid4,goal,27703,27754,51
471,vid4,pass,28142,28194,52
472,vid4,pass,28246,28295,49
474,vid4,goal,28388,28417,29
476,vid4,pass,29387,29430,43
477,vid4,tackle,29451,29470,19
478,vid4,pass,29862,29904,42
479,vid4,pass,30004,30036,32
480,vid4,pass,30031,30089,58
481,vid4,tackle,30114,30126,12
482,vid4,pass,30856,30904,48
483,vid4,pass,30914,30983,69
484,vid4,pass,32078,32116,38
486,vid4,pass,32619,32669,50
487,vid4,pass,32664,32694,30
488,vid4,pass,33074,33107,33
489,vid4,pass,33097,33126,29
491,vid4,pass,34786,34826,40
492,vid4,pass,34931,34979,48
493,vid4,pass,35737,35790,53
495,vid4,pass,35865,35915,50
496,vid4,tackle,35935,35980,45
497,vid4,pass,36165,36215,50
498,vid4,pass,36266,36341,75
499,vid4,pass,36786,36816,30
500,vid4,pass,37351,37431,80
502,vid4,tackle,37521,37565,44
503,vid4,pass,37747,37786,39
504,vid4,pass,37836,37886,50
505,vid4,pass,37931,37946,15
506,vid4,tackle,38051,38086,35
507,vid4,pass,38791,38838,47
509,vid4,pass,39170,39220,50
510,vid4,pass,39215,39250,35
511,vid4,pass,39240,39300,60
512,vid4,pass,39890,39945,55
513,vid4,tackle,40311,40344,33
514,vid4,save,40505,40518,13
515,vid4,tackle,40588,40619,31
516,vid4,pass,41029,41099,70
517,vid4,pass,41104,41149,45
518,vid4,save,41249,41314,65
519,vid4,tackle,41454,41534,80
520,vid4,pass,41754,41809,55
521,vid4,pass,41899,41959,60
522,vid4,pass,42365,42423,58
523,vid4,pass,42847,42897,50
524,vid4,save,43239,43270,31
525,vid4,pass,43379,43419,40
528,vid4,pass,43893,43925,32
530,vid4,pass,44270,44319,49
531,vid4,pass,44424,44469,45
532,vid4,pass,44494,44527,33
533,vid4,pass,44809,44851,42
535,vid4,tackle,45241,45260,19
536,vid4,pass,45600,45655,55
537,vid4,pass,45750,45790,40
538,vid4,pass,45810,45854,44
539,vid4,save,45934,45954,20
540,vid4,goal,46260,46302,42
541,vid4,pass,46478,46543,65
542,vid4,pass,46598,46642,44
543,vid4,pass,46675,46723,48
544,vid4,tackle,46727,46752,25
545,vid4,pass,46840,46885,45
546,vid4,tackle,47093,47112,19
547,vid4,pass,47359,47393,34
549,vid4,pass,48138,48208,70
550,vid4,pass,48322,48358,36
551,vid4,pass,48474,48515,41
552,vid4,goal,48506,48552,46
553,vid4,pass,48959,48999,40
555,vid4,pass,49617,49666,49
556,vid4,pass,50535,50589,54
557,vid4,tackle,50865,50895,30
559,vid4,pass,51638,51686,48
560,vid4,tackle,51955,51995,40
561,vid4,tackle,52058,52092,34
562,vid4,pass,52142,52202,60
563,vid4,pass,52793,52854,61
564,vid4,pass,52884,52955,71
565,vid4,pass,52995,53064,69
566,vid4,save,53168,53197,29
567,vid4,pass,54275,54316,41
568,vid4,pass,54664,54692,28
569,vid4,pass,54930,54967,37
570,vid4,save,55216,55246,30
571,vid4,pass,56376,56419,43
572,vid4,tackle,56464,56491,27
573,vid4,pass,57068,57116,48
574,vid4,pass,57425,57475,50
576,vid4,pass,58282,58324,42
577,vid4,pass,58502,58530,28
578,vid4,goal,58527,58568,41
579,vid4,pass,59244,59292,48
580,vid4,pass,59287,59331,44
581,vid4,pass,59841,59911,70
582,vid4,pass,60453,60496,43
583,vid4,pass,60531,60578,47
584,vid4,pass,61327,61362,35
585,vid4,pass,61377,61422,45
586,vid4,save,61432,61457,25
587,vid4,pass,61738,61780,42
589,vid4,goal,62277,62309,32
590,vid4,pass,68447,68502,55
591,vid4,pass,68552,68591,39
593,vid4,pass,68769,68800,31
594,vid4,save,68821,68866,45
595,vid4,pass,69319,69366,47
596,vid4,pass,69405,69452,47
597,vid4,pass,69732,69776,44
598,vid4,pass,70002,70057,55
599,vid4,save,70052,70112,60
600,vid4,pass,70146,70196,50
601,vid4,pass,70263,70302,39
602,vid4,pass,70467,70500,33
603,vid4,pass,70495,70570,75
605,vid4,pass,70653,70693,40
606,vid4,pass,70872,70967,95
607,vid4,pass,71035,71112,77
608,vid4,pass,71161,71206,45
612,vid4,goal,72159,72209,50
613,vid4,pass,72663,72697,34
614,vid4,save,73623,73647,24
616,vid4,tackle,74157,74175,18
617,vid4,pass,74385,74436,51
619,vid4,pass,75112,75173,61
620,vid4,goal,75245,75300,55
621,vid4,pass,75535,75560,25
622,vid4,pass,75850,75898,48
624,vid4,pass,76527,76570,43
626,vid4,pass,76941,76986,45
627,vid4,pass,77353,77392,39
628,vid4,pass,77387,77404,17
629,vid4,pass,77729,77781,52
630,vid4,tackle,78197,78217,20
631,vid4,pass,78206,78236,30
632,vid4,save,78275,78317,42
633,vid4,pass,79037,79095,58
634,vid4,pass,79718,79760,42
635,vid4,pass,80525,80568,43
636,vid4,tackle,80954,80979,25
637,vid4,pass,81229,81271,42
640,vid4,pass,81812,81839,27
641,vid4,pass,82330,82383,53
642,vid4,pass,82438,82485,47
643,vid4,pass,82595,82638,43
646,vid4,pass,83484,83548,64
647,vid4,save,83573,83607,34
648,vid4,pass,84056,84109,53
650,vid4,goal,84164,84199,35
651,vid4,tackle,84579,84600,21
652,vid4,pass,85602,85668,66
653,vid4,pass,85996,86043,47
654,vid4,goal,86338,86367,29
656,vid4,pass,86553,86585,32
657,vid4,pass,86613,86671,58
658,vid4,tackle,86792,86806,14
659,vid4,pass,86966,87012,46
660,vid4,goal,87297,87330,33
661,vid4,pass,87480,87540,60
662,vid4,pass,87625,87657,32
663,vid4,pass,87692,87739,47
664,vid4,pass,87974,88025,51
667,vid4,pass,88458,88491,33
668,vid4,tackle,88601,88630,29
671,vid4,goal,90104,90136,32
672,vid4,pass,90366,90390,24
673,vid4,pass,90445,90507,62
674,vid4,tackle,90528,90548,20
675,vid4,pass,90583,90617,34
677,vid4,goal,90762,90797,35
678,vid4,pass,90945,90985,40
679,vid4,pass,91187,91242,55
680,vid4,pass,91267,91321,54
681,vid4,pass,91316,91381,65
682,vid4,pass,91406,91446,40
683,vid4,pass,91486,91526,40
684,vid4,pass,91582,91626,44
686,vid4,pass,92187,92242,55
687,vid4,tackle,92271,92292,21
688,vid4,tackle,92317,92343,26
689,vid4,pass,92393,92443,50
690,vid4,pass,92964,93015,51
692,vid4,pass,93358,93404,46
693,vid4,pass,93404,93469,65
694,vid4,goal,93467,93488,21
695,vid4,pass,93809,93864,55
696,vid4,pass,93929,93961,32
697,vid4,tackle,94046,94086,40
698,vid4,pass,94325,94365,40
699,vid4,pass,94400,94436,36
700,vid4,pass,94456,94504,48
701,vid4,pass,94571,94631,60
702,vid4,tackle,94985,94999,14
703,vid4,tackle,95039,95058,19
704,vid4,pass,95323,95379,56
705,vid4,pass,95534,95584,50
706,vid4,pass,95609,95639,30
707,vid4,tackle,95694,95738,44
708,vid4,pass,96261,96298,37
709,vid4,pass,96313,96376,63
710,vid4,tackle,97109,97123,14
711,vid4,pass,97266,97334,68
712,vid4,goal,97344,97386,42
713,vid4,pass,97981,98063,82
715,vid4,pass,98436,98474,38
716,vid4,pass,98494,98550,56
717,vid4,pass,98575,98622,47
718,vid4,pass,98637,98678,41
719,vid5,goal,1767,1836,69
720,vid5,pass,1871,1920,49
721,vid5,pass,1955,1983,28
722,vid5,pass,2554,2599,45
723,vid5,pass,3374,3439,65
724,vid5,pass,3489,3533,44
725,vid5,tackle,4145,4170,25
726,vid5,goal,4593,4618,25
727,vid5,goal,4859,4909,50
728,vid5,goal,5839,5904,65
729,vid5,goal,6609,6655,46
730,vid5,goal,7541,7580,39
731,vid5,pass,7905,7947,42
732,vid5,goal,8352,8387,35
733,vid5,goal,9025,9078,53
734,vid5,goal,9198,9230,32
735,vid5,goal,9335,9383,48
736,vid5,pass,9938,10012,74
737,vid5,pass,10332,10382,50
738,vid5,goal,10377,10412,35
739,vid5,goal,11284,11322,38
740,vid5,goal,12165,12223,58
741,vid5,pass,13472,13507,35
742,vid5,pass,13542,13561,19
743,vid5,pass,14267,14312,45
744,vid5,tackle,14588,14607,19
745,vid5,pass,17001,17036,35
746,vid5,pass,17109,17142,33
747,vid5,save,17183,17217,34
748,vid5,pass,17260,17296,36
749,vid5,pass,17506,17546,40
750,vid5,tackle,19021,19040,19
751,vid5,pass,19519,19541,22
752,vid5,pass,19711,19738,27
753,vid5,tackle,20318,20333,15
754,vid5,tackle,21462,21503,41
755,vid5,pass,21697,21721,24
757,vid5,goal,22683,22710,27
758,vid5,pass,22990,23040,50
759,vid5,pass,23319,23353,34
760,vid5,save,23348,23378,30
761,vid5,pass,25183,25233,50
762,vid5,pass,25247,25278,31
764,vid5,pass,25825,25850,25
765,vid5,pass,27580,27631,51
766,vid5,pass,27752,27798,46
767,vid5,pass,27863,27901,38
768,vid5,tackle,28031,28054,23
769,vid5,pass,28164,28211,47
770,vid5,pass,28624,28694,70
771,vid5,save,29004,29034,30
772,vid5,tackle,30549,30574,25
773,vid5,save,30584,30608,24
775,vid5,tackle,33159,33196,37
776,vid5,pass,33194,33245,51
777,vid5,goal,33241,33274,33
778,vid5,tackle,33525,33550,25
779,vid5,pass,33635,33670,35
780,vid5,pass,33735,33775,40
781,vid5,pass,34517,34556,39
782,vid5,goal,34741,34782,41
783,vid5,pass,34957,35001,44
785,vid5,pass,35130,35184,54
786,vid5,pass,37585,37635,50
787,vid5,goal,38667,38705,38
788,vid5,pass,38865,38915,50
789,vid5,pass,38961,38996,35
790,vid5,pass,40426,40482,56
791,vid5,tackle,40614,40637,23
792,vid5,tackle,40822,40836,14
793,vid5,pass,41658,41694,36
794,vid5,save,41699,41727,28
795,vid5,pass,41762,41797,35
796,vid5,pass,41832,41862,30
797,vid5,pass,41867,41907,40
798,vid5,tackle,42317,42331,14
799,vid5,pass,44011,44051,40
800,vid5,pass,44051,44094,43
801,vid5,pass,44124,44139,15
802,vid5,tackle,45109,45141,32
803,vid5,tackle,45161,45207,46
804,vid5,pass,45625,45649,24
805,vid5,goal,45672,45700,28
806,vid5,pass,46114,46159,45
808,vid5,pass,46336,46388,52
809,vid5,pass,46483,46526,43
810,vid5,tackle,46956,46992,36
811,vid5,tackle,47010,47039,29
812,vid5,pass,49228,49263,35
813,vid5,pass,49592,49632,40
815,vid5,pass,49712,49748,36
816,vid5,pass,51077,51102,25
818,vid5,goal,53868,53893,25
820,vid5,pass,54370,54403,33
821,vid5,pass,54803,54835,32
822,vid5,save,54845,54857,12
823,vid5,pass,55908,55935,27
824,vid5,tackle,56080,56114,34
825,vid5,pass,56783,56811,28
826,vid5,pass,56844,56904,60
827,vid5,pass,57049,57086,37
828,vid5,pass,57086,57123,37
829,vid5,pass,57543,57595,52
830,vid5,save,57815,57829,14
831,vid5,tackle,57894,57919,25
832,vid5,tackle,58535,58562,27
833,vid5,tackle,59312,59334,22
834,vid5,pass,59359,59406,47
835,vid5,save,59446,59468,22
836,vid5,pass,59688,59736,48
837,vid5,goal,59729,59792,63
838,vid5,pass,60297,60342,45
840,vid5,pass,63170,63216,46
841,vid5,save,64046,64081,35
842,vid5,pass,64319,64340,21
844,vid5,pass,65117,65150,33
845,vid5,pass,65420,65487,67
846,vid5,tackle,65492,65505,13
847,vid5,tackle,65905,65931,26
848,vid5,pass,66096,66131,35
849,vid5,pass,66161,66203,42
850,vid5,pass,66868,66914,46
851,vid5,pass,66949,66963,14
852,vid5,pass,66962,66987,25
853,vid5,tackle,67482,67522,40
854,vid5,tackle,68042,68066,24
855,vid5,pass,68666,68720,54
856,vid5,tackle,68722,68734,12
857,vid5,goal,69604,69643,39
858,vid5,goal,75115,75160,45
859,vid5,pass,75630,75680,50
861,vid5,pass,75788,75834,46
862,vid5,pass,75844,75894,50
863,vid5,pass,76059,76099,40
864,vid5,pass,76609,76664,55
865,vid5,pass,76739,76820,81
866,vid5,pass,76935,76977,42
867,vid5,pass,78126,78171,45
868,vid5,pass,78361,78406,45
869,vid5,save,78699,78721,22
870,vid5,tackle,79671,79689,18
871,vid5,pass,79699,79716,17
873,vid5,pass,79739,79827,88
874,vid5,pass,79817,79886,69
875,vid5,pass,80891,80937,46
876,vid5,pass,81005,81062,57
877,vid5,pass,81929,81984,55
878,vid5,save,83523,83546,23
879,vid5,save,83602,83641,39
880,vid5,pass,83751,83796,45
881,vid5,goal,87075,87105,30
882,vid5,pass,87790,87835,45
883,vid5,pass,87925,87976,51
884,vid5,pass,88016,88055,39
885,vid5,pass,88081,88141,60
886,vid5,pass,89968,90003,35
887,vid5,pass,90028,90077,49
888,vid5,pass,92616,92647,31
889,vid5,pass,92672,92695,23
890,vid5,pass,93493,93526,33
891,vid5,goal,93546,93571,25
892,vid5,pass,93826,93885,59
894,vid5,pass,96553,96579,26
895,vid5,tackle,97157,97169,12
896,vid5,pass,98350,98386,36
897,vid5,pass,99809,99824,15
898,vid5,pass,100458,100482,24
899,vid5,pass,100617,100647,30
900,vid5,pass,101092,101129,37
901,vid5,pass,102655,102684,29
902,vid5,pass,103187,103229,42
903,vid5,goal,103692,103741,49
904,yt1,pass,75,135,60
907,yt1,pass,1190,1250,60
908,yt1,pass,1365,1445,80
911,yt1,pass,2065,2145,80
914,yt1,pass,2876,2976,100
915,yt1,tackle,3481,3506,25
916,yt1,pass,4191,4281,90
919,yt1,pass,5738,5805,67
920,yt1,pass,5955,6045,90
921,yt1,save,7540,7605,65
922,yt1,pass,7990,8040,50
924,yt1,pass,8385,8420,35
926,yt1,pass,9365,9435,70
927,yt1,pass,9480,9540,60
928,yt1,pass,9655,9755,100
929,yt1,pass,10290,10390,100
930,yt1,tackle,10535,10570,35
933,yt1,pass,12569,12602,33
935,yt1,pass,14652,14727,75
938,yt1,tackle,15013,15047,34
940,yt1,pass,15267,15357,90
941,yt1,save,16012,16057,45
942,yt1,pass,16382,16477,95
943,yt1,pass,16507,16562,55
945,yt1,pass,16882,16972,90
946,yt1,pass,17572,17647,75
947,yt1,pass,18077,18132,55
948,yt1,pass,18507,18567,60
949,yt1,pass,18622,18682,60
950,yt1,save,18777,18817,40
951,yt1,pass,19372,19472,100
952,yt1,save,19522,19557,35
953,yt1,save,19872,19918,46
954,yt1,pass,20372,20467,95
955,yt1,pass,20747,20812,65
956,yt1,pass,21532,21602,70
957,yt1,pass,21647,21702,55
958,yt1,pass,21877,21952,75
959,yt1,tackle,22047,22092,45
962,yt1,pass,24127,24212,85
963,yt1,tackle,24237,24253,16
964,yt1,tackle,24373,24421,48
965,yt1,pass,24516,24593,77
966,yt1,pass,24633,24703,70
968,yt1,pass,25384,25469,85
969,yt1,pass,25564,25642,78
971,yt1,pass,25802,25842,40
972,yt1,tackle,25947,25987,40
973,yt1,pass,26047,26140,93
974,yt1,pass,26495,26565,70
975,yt1,pass,26795,26865,70
976,yt1,pass,27495,27555,60
978,yt1,pass,27755,27825,70
979,yt1,pass,27820,27900,80
980,yt1,pass,27950,28035,85
981,yt1,save,28080,28140,60
982,yt1,pass,28695,28770,75
984,yt1,pass,28930,28980,50
986,yt1,pass,29200,29280,80
988,yt1,pass,30095,30165,70
989,yt1,pass,30780,30840,60
990,yt1,pass,30835,30925,90
991,yt1,pass,30935,31010,75
992,yt1,save,31140,31190,50
993,yt1,save,31260,31295,35
994,yt1,tackle,31440,31455,15
995,yt1,tackle,31775,31810,35
997,yt1,pass,32555,32610,55
999,yt1,goal,32920,32970,50
1000,yt1,pass,33505,33540,35
1001,yt1,save,33535,33595,60
1003,yt1,pass,34003,34078,75
1005,yt1,tackle,34198,34228,30
1006,yt1,pass,34908,34978,70
1008,yt1,goal,35518,35558,40
1010,yt1,pass,36591,36661,70
1011,yt1,pass,36731,36791,60
1012,yt1,pass,36786,36856,70
1015,yt1,pass,40091,40153,62
1016,yt1,goal,40148,40203,55
1021,yt1,pass,42633,42693,60
1026,yt1,pass,44183,44262,79
1027,yt1,pass,44867,44967,100
1028,yt1,pass,45077,45177,100
1029,yt1,pass,45557,45637,80
1030,yt1,pass,45677,45767,90
1031,yt1,pass,47482,47542,60
1032,yt1,pass,47672,47762,90
1033,yt1,pass,47812,47882,70
1034,yt1,pass,48662,48727,65
1036,yt1,tackle,49847,49892,45
1037,yt1,tackle,49987,50012,25
1038,yt1,pass,52037,52132,95
1039,yt1,pass,52337,52407,70
1040,yt1,pass,52582,52647,65
1042,yt1,pass,57242,57307,65
1043,yt1,pass,57982,58052,70
1047,yt1,save,60352,60379,27
1048,yt1,pass,60829,60904,75
1050,yt1,save,61523,61618,95
1051,yt1,pass,61633,61723,90
1052,yt1,pass,61733,61818,85
1053,yt1,tackle,62113,62143,30
1054,yt1,tackle,62748,62788,40
1056,yt1,pass,63863,63942,79
1059,yt1,pass,65612,65682,70
1060,yt1,tackle,65702,65792,90
1061,yt1,pass,65832,65892,60
1062,yt1,pass,68102,68167,65
1063,yt1,tackle,68212,68247,35
1064,yt1,pass,68707,68797,90
1065,yt1,pass,69112,69197,85
1067,yt1,save,70732,70759,27
1069,yt1,pass,72269,72319,50
1070,yt1,pass,73299,73368,69
1071,yt1,pass,73363,73443,80
1072,yt1,pass,74688,74752,64
1073,yt1,pass,75572,75642,70
1074,yt1,pass,75637,75727,90
1077,yt1,pass,77207,77292,85
1078,yt1,pass,77362,77412,50
1079,yt1,pass,77522,77572,50
1081,yt1,pass,77866,77925,59
1082,yt1,pass,78200,78280,80
1083,yt1,pass,78340,78418,78
1086,yt1,save,79201,79244,43
1087,yt1,pass,79379,79469,90
1088,yt1,tackle,79753,79783,30
1089,yt1,pass,79873,79971,98
1090,yt1,save,80021,80040,19
1091,yt1,pass,80710,80767,57
1092,yt1,pass,80822,80922,100
1093,yt1,save,81022,81072,50
1094,yt1,pass,81727,81787,60
1096,yt1,pass,82615,82673,58
1097,yt1,pass,82668,82752,84
1103,yt1,pass,83540,83624,84
1104,yt1,pass,83677,83762,85
1106,yt1,pass,84634,84713,79
1109,yt1,pass,86073,86138,65
1110,yt1,save,86188,86228,40
1112,yt1,pass,87023,87072,49
1113,yt1,pass,87512,87562,50
1114,yt1,pass,88132,88232,100
1118,yt1,pass,89830,89900,70
1119,yt1,pass,90010,90102,92
1120,yt1,pass,90132,90227,95
1121,yt1,pass,90222,90307,85
1122,yt1,pass,90402,90452,50
1123,yt1,tackle,90667,90705,38
1126,yt1,pass,91569,91602,33
1128,yt1,tackle,91824,91874,50
1130,yt1,pass,92454,92524,70
1131,yt1,pass,92599,92634,35
1132,yt1,pass,92939,93034,95
1134,yt1,goal,93184,93254,70
1135,yt1,pass,93894,93939,45
1136,yt1,pass,93979,94074,95
1138,yt1,pass,94354,94449,95
1139,yt1,pass,94489,94559,70
1140,yt1,pass,94644,94694,50
1141,yt1,pass,94814,94884,70
1142,yt1,pass,95699,95769,70
1143,yt1,pass,95764,95854,90
1144,yt1,pass,95949,96044,95
1145,yt1,pass,96044,96139,95
1146,yt1,pass,96804,96886,82
1147,yt1,pass,97146,97218,72
1148,yt1,tackle,97268,97293,25
1149,yt1,pass,97463,97533,70
1150,yt1,pass,97648,97733,85
1151,yt1,pass,97962,98022,60
1152,yt1,pass,98856,98931,75
1154,yt1,pass,99226,99306,80
1155,yt1,pass,99446,99511,65
1157,yt1,pass,100809,100900,91
1158,yt1,pass,100895,100950,55
1159,yt1,pass,101105,101195,90
1160,yt1,tackle,101245,101300,55
1161,yt1,pass,101595,101660,65
1162,yt1,pass,101680,101740,60
1163,yt1,pass,102952,103027,75
1164,yt1,pass,103082,103139,57
1166,yt1,pass,103608,103633,25
1167,yt1,pass,103798,103887,89
1170,yt1,pass,104204,104264,60
1171,yt1,pass,104284,104311,27
1172,yt1,pass,104866,104936,70
1174,yt1,pass,106730,106809,79
1175,yt1,pass,106804,106864,60
1176,yt1,pass,109044,109109,65
1177,yt1,pass,109994,110069,75
1178,yt1,pass,110619,110684,65
1179,yt1,pass,111224,111299,75
1180,yt1,pass,112639,112734,95
1181,yt1,pass,113249,113336,87
1182,yt1,pass,114555,114630,75
1183,yt1,pass,115210,115295,85
1184,yt1,pass,115455,115515,60
1186,yt1,pass,116256,116336,80
1188,yt1,pass,116636,116691,55
1191,yt1,pass,117166,117221,55
1192,yt1,pass,117256,117326,70
1193,yt1,tackle,117582,117598,16
1194,yt1,pass,118428,118501,73
1195,yt1,pass,118493,118561,68
1197,yt1,pass,119449,119528,79
1198,yt1,goal,119567,119638,71
1199,yt1,pass,120518,120588,70
1201,yt1,pass,120831,120916,85
1202,yt1,pass,121071,121161,90
1203,yt1,pass,121516,121601,85
1204,yt1,pass,122011,122086,75
1206,yt1,tackle,122461,122478,17
1207,yt1,pass,123518,123570,52
1208,yt1,pass,123770,123837,67
1209,yt1,save,123867,123892,25
1210,yt1,pass,124427,124502,75
1211,yt1,pass,125667,125757,90
1212,yt1,pass,126672,126745,73
1215,yt1,pass,127070,127162,92
1217,yt1,pass,128672,128752,80
1218,yt1,pass,128847,128926,79
1219,yt1,pass,129446,129526,80
1220,yt1,pass,130621,130711,90
1221,yt1,pass,130831,130901,70
1222,yt1,pass,133071,133166,95
1223,yt1,pass,133161,133196,35
1224,yt1,pass,133881,133963,82
1225,yt1,pass,134635,134705,70
1226,yt1,pass,134885,134970,85
1228,yt1,pass,136615,136700,85
1229,yt1,pass,137676,137736,60
1231,yt1,pass,139312,139406,94
1232,yt1,save,140041,140111,70
1234,yt1,save,140814,140854,40
1235,yt1,save,141748,141813,65
1238,yt1,pass,143117,143182,65
1239,yt1,pass,143257,143317,60
1240,yt1,pass,143313,143382,69
1241,yt1,pass,143607,143662,55
1242,yt1,save,143697,143740,43
1243,yt1,pass,143935,144025,90
1244,yt1,pass,144235,144307,72
1245,yt1,pass,144362,144443,81
1249,yt2,goal,892,969,77
1251,yt2,goal,1034,1113,79
1252,yt2,pass,2010,2104,94
1254,yt2,pass,2251,2281,30
1256,yt2,pass,3233,3302,69
1257,yt2,pass,3655,3716,61
1258,yt2,goal,3861,3926,65
1260,yt2,goal,4168,4257,89
1262,yt2,pass,4890,4954,64
1265,yt2,pass,6095,6142,47
1266,yt2,pass,6192,6257,65
1267,yt2,pass,6432,6486,54
1269,yt2,pass,7126,7204,78
1271,yt2,pass,9206,9255,49
1274,yt2,goal,10208,10308,100
1275,yt2,goal,10731,10788,57
1276,yt2,pass,10928,11005,77
1277,yt2,goal,11065,11165,100
1278,yt2,goal,11894,11958,64
1279,yt2,goal,12276,12348,72
1281,yt2,pass,12512,12578,66
1282,yt2,pass,12565,12640,75
1283,yt2,pass,12632,12701,69
1284,yt2,pass,12696,12740,44
1287,yt2,goal,14309,14382,73
1288,yt2,pass,14972,15040,68
1289,yt2,pass,15035,15093,58
1290,yt2,pass,15083,15139,56
1292,yt2,pass,16864,16939,75
1293,yt2,pass,16934,16959,25
1296,yt2,goal,21681,21717,36
1298,yt2,goal,23929,24018,89
1299,yt2,pass,24239,24280,41
1300,yt2,pass,24275,24358,83
1301,yt2,pass,24353,24418,65
1302,yt2,pass,24448,24504,56
1304,yt2,pass,25520,25585,65
1305,yt2,tackle,25610,25641,31
1306,yt2,pass,26359,26422,63
1307,yt2,pass,27512,27546,34
1308,yt2,tackle,27616,27638,22
1309,yt2,pass,27803,27863,60
1311,yt2,pass,28154,28214,60
1312,yt2,save,28279,28320,41
1314,yt2,tackle,28734,28762,28
1315,yt2,pass,29302,29357,55
1317,yt2,pass,30142,30190,48
1318,yt2,pass,30182,30262,80
1319,yt2,tackle,30259,30299,40
1321,yt2,save,31138,31168,30
1322,yt2,goal,31562,31612,50
1323,yt2,pass,32492,32571,79
1324,yt2,pass,33541,33600,59
1325,yt2,goal,33595,33633,38
1326,yt2,pass,34083,34158,75
1327,yt2,pass,34498,34574,76
1328,yt2,tackle,34699,34744,45
1330,yt2,pass,35095,35191,96
1331,yt2,pass,35491,35543,52
1332,yt2,tackle,35708,35744,36
1333,yt2,save,35959,36036,77
1334,yt2,tackle,37318,37377,59
1335,yt2,pass,37782,37840,58
1336,yt2,pass,37830,37893,63
1337,yt2,pass,38043,38092,49
1338,yt2,tackle,38158,38191,33
1339,yt2,tackle,39873,39898,25
1340,yt2,pass,40063,40121,58
1341,yt2,pass,40111,40181,70
1342,yt2,pass,40241,40340,99
1344,yt2,pass,40770,40844,74
1345,yt2,pass,40899,40961,62
1347,yt2,pass,41885,41945,60
1348,yt2,tackle,41930,41982,52
1349,yt2,pass,42552,42593,41
1350,yt2,pass,43712,43778,66
1351,yt2,tackle,43828,43873,45
1352,yt2,tackle,43948,43964,16
1353,yt2,tackle,44124,44149,25
1354,yt2,tackle,44329,44350,21
1355,yt2,pass,44630,44688,58
1356,yt2,pass,44818,44881,63
1357,yt2,pass,44941,45031,90
1358,yt2,pass,45118,45202,84
1359,yt2,goal,45352,45398,46
1361,yt2,pass,45696,45729,33
1363,yt2,pass,48280,48351,71
1364,yt2,pass,48486,48521,35
1365,yt2,pass,49206,49286,80
1366,yt2,save,49321,49346,25
1367,yt2,pass,49671,49760,89
1369,yt2,save,50165,50199,34
1370,yt2,pass,50299,50355,56
1371,yt2,pass,50718,50795,77
1372,yt2,pass,51182,51258,76
1373,yt2,pass,51253,51307,54
1374,yt2,pass,51402,51469,67
1375,yt2,pass,52579,52644,65
1376,yt2,pass,52639,52696,57
1377,yt2,goal,52689,52728,39
1379,yt2,pass,53777,53839,62
1380,yt2,pass,53984,54029,45
1382,yt2,tackle,54194,54211,17
1383,yt2,save,54199,54261,62
1384,yt2,goal,54308,54360,52
1386,yt2,tackle,55355,55368,13
1389,yt2,tackle,55795,55815,20
1390,yt2,pass,55975,56045,70
1391,yt2,pass,56125,56197,72
1392,yt2,pass,56357,56437,80
1393,yt2,pass,56457,56487,30
1394,yt2,pass,56617,56702,85
1395,yt2,pass,56872,56922,50
1396,yt2,pass,57377,57457,80
1398,yt2,pass,57837,57892,55
1399,yt2,pass,58227,58292,65
1400,yt2,pass,58637,58702,65
1401,yt2,goal,58947,58997,50
1402,yt2,pass,59597,59662,65
1403,yt2,pass,59847,59902,55
1404,yt2,pass,60642,60717,75
1405,yt2,pass,60952,61032,80
1406,yt2,pass,61047,61127,80
1407,yt2,pass,61142,61207,65
1408,yt2,pass,61297,61364,67
1409,yt2,pass,61434,61494,60
1410,yt2,tackle,61524,61549,25
1411,yt2,tackle,63419,63459,40
1412,yt2,pass,63499,63589,90
1413,yt2,tackle,63619,63644,25
1414,yt2,pass,64034,64064,30
1415,yt2,pass,64859,64929,70
1417,yt2,pass,66809,66858,49
1418,yt2,goal,66858,66903,45
1420,yt2,pass,68148,68194,46
1421,yt2,tackle,68192,68209,17
1422,yt2,pass,68474,68534,60
1423,yt2,save,69094,69119,25
1424,yt2,pass,69789,69864,75
1425,yt2,save,69934,69969,35
1426,yt2,tackle,70314,70354,40
1427,yt2,tackle,70354,70379,25
1428,yt2,pass,70514,70559,45
1429,yt2,goal,71269,71329,60
1430,yt2,pass,72354,72424,70
1431,yt2,pass,72654,72724,70
1432,yt2,pass,72929,72989,60
1434,yt2,tackle,73689,73744,55
1435,yt2,pass,74104,74165,61
1436,yt2,pass,74420,74485,65
1438,yt2,save,75175,75220,45
1440,yt2,pass,77145,77215,70
1441,yt2,pass,77685,77760,75
1442,yt2,pass,77790,77855,65
1443,yt2,save,77900,77965,65
1444,yt2,pass,78205,78260,55
1445,yt2,save,78385,78435,50
1446,yt2,pass,78645,78720,75
1447,yt2,pass,78905,78985,80
1448,yt2,tackle,79035,79070,35
1450,yt2,goal,81480,81560,80
1451,yt2,goal,82790,82875,85
1452,yt2,pass,83315,83385,70
1454,yt2,goal,84082,84142,60
1456,yt2,pass,84612,84670,58
1457,yt2,pass,85060,85160,100
1458,yt2,goal,86230,86290,60
1460,yt2,pass,88310,88390,80
1461,yt2,save,89850,89920,70
1462,yt2,goal,90895,90955,60
1463,yt2,pass,91515,91590,75
1464,yt2,goal,91625,91700,75
1465,yt2,tackle,92615,92650,35
1466,yt2,pass,93805,93875,70
1467,yt2,goal,94075,94145,70
1468,yt2,tackle,94560,94600,40
1469,yt2,pass,94820,94885,65
1470,yt2,pass,95005,95045,40
1472,yt2,goal,95440,95495,55
1473,yt2,pass,95878,95943,65
1474,yt2,tackle,95983,96023,40
1475,yt2,goal,96578,96633,55
1476,yt2,pass,97163,97253,90
1478,yt2,pass,98838,98898,60
1479,yt2,goal,99583,99643,60
1480,yt2,pass,100158,100243,85
1482,yt2,pass,100543,100583,40
1483,yt2,pass,101528,101610,82
1484,yt2,pass,101605,101680,75
1485,yt2,save,101675,101718,43
1486,yt2,pass,102778,102868,90
1487,yt2,save,103123,103153,30
1489,yt2,pass,105488,105558,70
1490,yt2,tackle,106308,106363,55
1491,yt2,tackle,106423,106458,35
1492,yt2,tackle,107568,107598,30
1493,yt2,tackle,108158,108183,25
1494,yt2,goal,111520,111555,35
1495,yt2,tackle,112040,112080,40
1496,yt2,tackle,112415,112458,43
1497,yt2,pass,112768,112813,45
1499,yt2,pass,113369,113439,70
1500,yt2,tackle,113630,113666,36
1501,yt2,pass,114636,114676,40
1502,yt2,pass,115196,115263,67
1503,yt2,save,115266,115306,40
1504,yt2,tackle,115871,115916,45
1505,yt2,tackle,115946,115987,41
1506,yt2,tackle,116087,116127,40
1507,yt2,tackle,116807,116837,30
1508,yt2,pass,117112,117153,41
1509,yt2,pass,117303,117378,75
1510,yt2,save,117913,117978,65
1511,yt2,tackle,118724,118766,42
1512,yt2,pass,119794,119859,65
1514,yt2,pass,120739,120813,74
1515,yt2,pass,121893,121973,80
1518,yt2,pass,123413,123498,85
1519,yt2,pass,123648,123718,70
1521,yt2,goal,123863,123948,85
1522,yt2,pass,124464,124549,85
1523,yt2,pass,124749,124794,45
1524,yt2,pass,124929,125019,90
1526,yt2,tackle,125964,126004,40
1527,yt2,pass,126174,126264,90
1528,yt2,pass,127719,127764,45
1529,yt2,pass,127784,127869,85
1531,yt2,pass,129149,129209,60
1532,yt2,save,129264,129359,95
1533,yt2,pass,129564,129659,95
1534,yt2,goal,129689,129734,45
1535,yt2,pass,129869,129959,90
1536,yt2,pass,130109,130174,65
1537,yt2,pass,130169,130224,55
1538,yt2,goal,130314,130364,50
1539,yt2,pass,130954,131027,73
1540,yt2,pass,132013,132072,59
1541,yt2,pass,133557,133657,100
1542,yt2,goal,133652,133712,60
1544,yt2,pass,134197,134252,55
1545,yt2,goal,134247,134327,80
1547,yt2,pass,135592,135647,55
1548,yt2,pass,135747,135797,50
1549,yt2,save,135832,135877,45
1552,yt2,pass,136648,136688,40
1553,yt2,tackle,136693,136728,35
1554,yt2,save,136738,136768,30
1555,yt2,pass,137268,137323,55
1560,yt2,pass,139048,139143,95
1561,yt2,pass,139203,139288,85
1562,yt2,save,139439,139469,30
1563,yt2,pass,140004,140064,60
1565,yt2,pass,140519,140619,100
1566,yt2,pass,140944,140989,45
1567,yt2,pass,141079,141149,70
1568,yt2,save,141274,141319,45
1569,yt2,tackle,141834,141864,30
1570,yt2,pass,142214,142254,40
1571,yt2,save,142389,142424,35
1573,yt2,pass,143844,143924,80
1574,yt2,pass,144164,144241,77
1575,yt2,goal,148271,148341,70
1576,yt2,goal,148851,148931,80
1577,yt2,pass,149576,149671,95
1578,yt2,pass,151296,151381,85
1579,yt2,pass,151451,151536,85
1580,yt2,pass,151867,151907,40
1581,yt2,pass,152967,153017,50
1582,yt2,pass,153012,153092,80
1584,yt2,pass,154502,154557,55
1585,yt2,goal,154577,154627,50
1586,yt2,pass,155272,155327,55
1587,yt2,goal,155352,155402,50
1588,yt2,pass,155767,155852,85
1589,yt2,pass,155872,155952,80
1591,yt2,pass,157042,157087,45
1592,yt2,pass,157182,157272,90
1593,yt2,pass,157297,157347,50
1594,yt2,pass,157367,157462,95
1595,yt2,save,157457,157522,65
1597,yt2,pass,158502,158577,75
1598,yt2,pass,158647,158662,15
1599,yt2,pass,158772,158822,50
1600,yt2,pass,158857,158932,75
1601,yt2,pass,158972,159057,85
1603,yt2,pass,159828,159893,65
1604,yt2,pass,159918,160008,90
1605,yt2,goal,160548,160588,40
1606,yt2,tackle,161513,161548,35
1607,yt2,tackle,161653,161675,22
1608,yt2,tackle,161770,161814,44
1609,yt2,pass,161914,161998,84
1610,yt2,pass,162893,162943,50
1612,yt2,pass,163165,163230,65
1613,yt2,goal,163225,163285,60
1614,yt2,pass,163750,163825,75
1615,yt2,tackle,164140,164160,20
1616,yt2,pass,164905,164970,65
1618,yt2,pass,165688,165748,60
1619,yt2,pass,166358,166380,22
1620,yt2,pass,166376,166420,44
1621,yt2,pass,166765,166835,70
1623,yt2,pass,167045,167118,73
1624,yt2,pass,168175,168260,85
1626,yt2,tackle,168625,168650,25
1627,yt2,tackle,169025,169125,100
1628,yt2,tackle,169215,169250,35
1629,yt2,tackle,169435,169500,65
1630,yt2,pass,169855,169940,85
1631,yt2,tackle,169925,169950,25
1633,yt2,pass,170739,170804,65
1634,yt2,pass,170799,170849,50
1635,yt2,pass,170844,170899,55
1636,yt2,pass,171014,171084,70
1637,yt2,pass,171254,171299,45
1640,yt2,pass,172009,172074,65
1641,yt2,pass,172249,172319,70
1642,yt2,pass,172754,172796,42
1644,yt2,pass,173226,173291,65
1645,yt2,pass,173301,173366,65
1646,yt2,pass,174051,174116,65
1647,yt2,pass,174481,174536,55
1648,yt2,pass,174776,174831,55
1649,yt2,pass,174936,175001,65
1650,yt2,pass,174998,175026,28
1651,yt2,pass,175111,175146,35
1652,yt2,pass,175706,175791,85
1653,yt2,pass,175836,175916,80
1654,yt2,pass,175971,176066,95
1655,yt2,pass,177256,177306,50
1656,yt2,pass,177716,177815,99
1657,yt2,pass,177810,177880,70
1658,yt2,pass,178975,179045,70
1660,yt2,pass,180395,180475,80
1661,yt2,pass,181180,181270,90
1662,yt2,pass,181450,181510,60
1663,yt2,tackle,181565,181590,25
1664,yt2,pass,181785,181850,65
1665,yt2,save,181875,181891,16
1666,yt2,goal,182106,182176,70
1668,yt2,pass,182941,182986,45
1669,yt2,goal,182981,183016,35
1670,yt2,pass,183156,183221,65
1671,yt2,pass,183311,183391,80
1672,yt2,save,183486,183546,60
1673,yt2,tackle,184721,184756,35
1674,yt2,goal,184746,184826,80
1675,yt2,pass,185561,185601,40
1677,yt2,goal,186126,186181,55
1679,yt2,pass,187121,187206,85
1680,yt2,pass,187266,187346,80
1681,yt2,goal,189131,189176,45
1683,yt2,pass,190419,190464,45
1684,yt2,goal,190619,190714,95
1686,yt2,tackle,192259,192314,55
1687,yt2,pass,192574,192664,90
1688,yt2,tackle,192759,192794,35
1689,yt2,goal,193129,193204,75
1690,yt2,pass,193809,193889,80
1692,yt2,goal,194044,194094,50
1693,yt2,pass,194621,194696,75
1694,yt2,pass,194720,194745,25
1696,yt2,pass,195860,195930,70
1697,yt2,goal,195925,195955,30
1698,yt2,pass,196645,196723,78
1699,yt2,goal,196719,196768,49
1700,yt2,pass,197388,197443,55
1701,yt2,pass,197473,197548,75
1702,yt2,pass,197808,197891,83
1704,yt2,pass,199616,199671,55
1705,yt2,pass,199721,199821,100
1706,yt2,pass,200386,200476,90
1708,yt2,pass,201041,201086,45
1709,yt2,pass,201111,201151,40
1710,yt2,pass,201571,201626,55
1712,yt2,tackle,202506,202551,45
1713,yt2,pass,204271,204356,85
1716,yt2,goal,204731,204791,60
1717,yt2,pass,205171,205241,70
1718,yt2,pass,206176,206271,95
1719,yt2,pass,206536,206596,60
1720,yt2,save,206591,206613,22
1721,yt2,pass,207303,207368,65
1722,yt2,pass,208368,208429,61
1723,yt2,pass,209034,209104,70
1724,yt2,tackle,210479,210519,40
1725,yt2,goal,210824,210869,45
1726,yt2,pass,211179,211249,70
1727,yt2,pass,211374,211474,100
1728,yt2,tackle,211499,211544,45
1729,yt2,tackle,211764,211819,55
1730,yt2,save,212564,212590,26
1731,yt2,pass,213030,213110,80
1732,yt2,pass,213430,213490,60
1733,yt2,pass,213985,214060,75
1734,yt2,save,214125,214170,45
1735,yt2,pass,215230,215280,50
1736,yt2,pass,215430,215505,75
1737,yt2,pass,215585,215640,55
1738,yt2,tackle,215735,215775,40
1739,yt2,save,215960,216000,40
1741,yt2,pass,217205,217245,40
1742,yt2,save,217310,217340,30
1743,yt2,pass,218485,218550,65
1744,yt2,pass,219140,219180,40
1745,yt2,tackle,219375,219395,20
1747,yt2,pass,219950,219985,35
1749,yt2,goal,220085,220120,35
1750,yt2,pass,220339,220429,90
1751,yt2,pass,221119,221199,80
1754,yt2,pass,222263,222341,78
1755,yt2,tackle,222543,222573,30
1756,yt2,save,222753,222778,25
1757,yt5,pass,1925,1980,55
1758,yt5,pass,2920,2950,30
1759,yt5,pass,2970,3000,30
1760,yt5,pass,3015,3050,35
1761,yt5,tackle,3115,3140,25
1762,yt5,pass,3170,3220,50
1763,yt5,pass,3670,3700,30
1764,yt5,tackle,3715,3735,20
1765,yt5,tackle,3741,3770,29
1766,yt5,goal,3775,3805,30
1768,yt5,pass,4005,4040,35
1770,yt5,goal,4210,4245,35
1771,yt5,pass,4334,4375,41
1772,yt5,pass,4435,4465,30
1773,yt5,tackle,4510,4529,19
1774,yt5,pass,4679,4729,50
1775,yt5,save,4819,4854,35
1776,yt5,pass,4924,4949,25
1777,yt5,pass,4974,5006,32
1779,yt5,pass,5316,5348,32
1780,yt5,pass,5458,5482,24
1782,yt5,pass,6062,6087,25
1783,yt5,pass,6227,6250,23
1784,yt5,pass,6285,6307,22
1785,yt5,save,6477,6517,40
1786,yt5,tackle,6717,6742,25
1787,yt5,pass,6927,6997,70
1788,yt5,pass,7151,7181,30
1789,yt5,goal,7201,7246,45
1790,yt5,pass,7356,7401,45
1791,yt5,pass,7496,7537,41
1792,yt5,pass,7722,7757,35
1793,yt5,goal,7752,7787,35
1794,yt5,pass,8106,8139,33
1795,yt5,pass,8149,8194,45
1796,yt5,tackle,8329,8349,20
1797,yt5,pass,8694,8734,40
1798,yt5,pass,8799,8830,31
1799,yt5,pass,8827,8870,43
1800,yt5,goal,9031,9085,54
1801,yt5,pass,9160,9185,25
1802,yt5,pass,9510,9535,25
1803,yt5,pass,9590,9620,30
1804,yt5,pass,9805,9839,34
1805,yt5,pass,9949,10034,85
1806,yt5,goal,10044,10069,25
1807,yt5,pass,10484,10525,41
1808,yt5,tackle,10530,10555,25
1809,yt5,goal,10575,10620,45
1810,yt5,pass,10930,10956,26
1811,yt5,pass,11271,11296,25
1813,yt5,pass,11351,11379,28
1814,yt5,goal,11509,11549,40
1816,yt5,pass,11819,11854,35
1817,yt5,pass,12139,12164,25
1818,yt5,pass,12214,12243,29
1819,yt5,pass,12283,12310,27
1820,yt5,pass,12625,12650,25
1821,yt5,save,12775,12810,35
1823,yt5,pass,13055,13083,28
1824,yt5,save,13080,13118,38
1825,yt5,pass,13148,13183,35
1826,yt5,pass,13208,13233,25
1827,yt5,tackle,13438,13453,15
1828,yt5,pass,13573,13603,30
1829,yt5,tackle,13708,13718,10
1830,yt5,pass,13828,13853,25
1831,yt5,save,14048,14063,15
1832,yt5,save,14188,14226,38
1833,yt5,pass,14281,14316,35
1834,yt5,pass,14466,14496,30
1835,yt5,pass,15099,15124,25
1836,yt5,pass,15224,15259,35
1837,yt5,save,15269,15294,25
1838,yt5,pass,15344,15379,35
1839,yt5,pass,15719,15749,30
1840,yt5,pass,15759,15784,25
1841,yt5,save,15854,15867,13
1842,yt5,pass,15962,16002,40
1843,yt5,save,16242,16261,19
1844,yt5,pass,16316,16345,29
1845,yt5,pass,17097,17134,37
1847,yt5,pass,17735,17770,35
1848,yt5,tackle,17770,17785,15
1849,yt5,pass,18315,18345,30
1851,yt5,save,18370,18401,31
1852,yt5,save,18601,18631,30
1853,yt5,pass,18771,18806,35
1854,yt5,goal,18841,18871,30
1855,yt5,pass,19016,19046,30
1856,yt5,pass,19136,19173,37
1857,yt5,pass,19455,19484,29
1858,yt5,goal,19479,19509,30
1859,yt5,pass,19689,19720,31
1860,yt5,pass,19742,19760,18
1861,yt5,save,20095,20154,59
1863,yt5,goal,20364,20399,35
1864,yt5,pass,20689,20733,44
1865,yt5,pass,20738,20773,35
1866,yt5,pass,20966,20989,23
1867,yt5,pass,21004,21024,20
1868,yt5,pass,21544,21579,35
1869,yt5,pass,21834,21864,30
1870,yt5,tackle,21929,21949,20
1871,yt5,pass,22116,22151,35
1872,yt5,pass,22276,22311,35
1873,yt5,pass,22374,22413,39
1874,yt5,goal,22411,22443,32
1876,yt5,tackle,22678,22703,25
1877,yt5,pass,23148,23168,20
1878,yt5,goal,23198,23223,25
1880,yt5,pass,23730,23747,17
1881,yt5,save,24217,24237,20
1882,yt5,pass,24507,24537,30
1883,yt5,pass,24622,24649,27
1884,yt5,tackle,24980,25005,25
1885,yt5,pass,25140,25194,54
1886,yt5,pass,25191,25219,28
1887,yt5,goal,25224,25250,26
1889,yt5,pass,25525,25570,45
1891,yt5,save,25845,25865,20
1892,yt5,pass,26005,26036,31
1893,yt5,pass,26476,26501,25
1895,yt5,pass,26535,26557,22
1896,yt5,pass,26582,26614,32
1897,yt5,tackle,26614,26639,25
1898,yt5,pass,26909,26935,26
1899,yt5,tackle,26961,26976,15
1900,yt5,goal,26987,27037,50
1901,yt5,pass,27402,27437,35
1902,yt5,pass,27457,27492,35
1903,yt5,save,27577,27607,30
1904,yt5,pass,27757,27792,35
1905,yt5,tackle,28172,28189,17
1906,yt5,pass,28464,28496,32
1907,yt5,pass,28494,28526,32
1908,yt5,pass,28651,28671,20
1909,yt5,goal,28736,28771,35
1910,yt5,pass,28936,28976,40
1911,yt5,pass,29121,29166,45
1912,yt5,pass,29162,29216,54
1913,yt5,pass,29251,29308,57
1914,yt5,pass,29403,29433,30
1915,yt5,pass,29548,29568,20
1916,yt5,pass,29564,29598,34
1917,yt5,save,29718,29738,20
1918,yt5,pass,30078,30098,20
1919,yt5,pass,30198,30240,42
1920,yt5,save,30240,30295,55
1921,yt5,pass,30595,30655,60
1923,yt5,pass,31010,31045,35
1924,yt5,pass,31350,31390,40
1926,yt5,pass,31695,31740,45
1927,yt5,pass,31745,31785,40
1928,yt5,pass,31845,31869,24
1929,yt5,pass,32619,32654,35
1930,yt5,pass,32664,32689,25
1931,yt5,tackle,32684,32704,20
1932,yt5,pass,32844,32874,30
1933,yt5,pass,32879,32909,30
1934,yt5,pass,33004,33044,40
1935,yt5,goal,33069,33094,25
1936,yt5,tackle,33569,33580,11
1937,yt5,pass,33625,33651,26
1938,yt5,pass,33931,33951,20
1939,yt5,save,34056,34081,25
1940,yt5,pass,34136,34156,20
1941,yt5,pass,34439,34481,42
1942,yt5,pass,34479,34516,37
1943,yt5,pass,34516,34571,55
1944,yt5,pass,34591,34631,40
1945,yt5,pass,34651,34676,25
1946,yt5,save,34674,34689,15
1948,yt5,pass,34984,35014,30
1950,yt5,pass,35176,35204,28
1951,yt5,pass,35201,35213,12
1952,yt5,pass,35318,35343,25
1953,yt5,tackle,35738,35763,25
1954,yt5,pass,35783,35813,30
1956,yt5,pass,36060,36087,27
1957,yt5,pass,36137,36179,42
1959,yt5,pass,36564,36619,55
1960,yt5,pass,37239,37285,46
1961,yt5,pass,37335,37355,20
1962,yt5,goal,37385,37435,50
1963,yt5,tackle,38335,38351,16
1964,yt5,pass,38446,38476,30
1965,yt5,pass,38486,38521,35
1966,yt5,pass,38576,38606,30
1967,yt5,pass,38706,38742,36
1968,yt5,pass,38738,38765,27
1969,yt5,pass,39074,39100,26
1970,yt5,pass,39322,39348,26
1972,yt5,pass,39389,39413,24
1973,yt5,pass,39423,39455,32
1974,yt5,pass,39525,39562,37
1975,yt5,pass,39577,39615,38
1976,yt5,pass,39930,39961,31
1977,yt5,pass,39966,39996,30
1978,yt5,save,39993,40010,17
1979,yt5,pass,40072,40106,34
1980,yt5,pass,40166,40213,47
1981,yt5,tackle,40243,40268,25
1982,yt5,pass,40553,40608,55
1983,yt5,pass,40838,40879,41
1984,yt5,pass,40969,41035,66
1985,yt5,pass,41169,41199,30
1988,yt5,pass,41402,41427,25
1990,yt5,pass,41842,41867,25
1991,yt5,tackle,42022,42047,25
1992,yt5,save,42192,42204,12
1993,yt5,goal,42809,42834,25
1994,yt5,pass,43104,43129,25
1995,yt5,pass,43917,43930,13
1996,yt5,goal,43940,43970,30
1997,yt5,pass,44105,44145,40
1998,yt5,pass,44205,44235,30
1999,yt5,tackle,44240,44280,40
2000,yt5,pass,44305,44330,25
2001,yt5,goal,44376,44420,44
2002,yt5,pass,44570,44608,38
2003,yt5,pass,44618,44658,40
2004,yt5,pass,44708,44738,30
2005,yt5,pass,44758,44782,24
2006,yt5,pass,45062,45105,43
2007,yt5,goal,45103,45135,32
2008,yt5,pass,45435,45475,40
2009,yt5,pass,46020,46045,25
2010,yt5,tackle,46070,46082,12
2011,yt5,tackle,46273,46298,25
2012,yt5,pass,46368,46385,17
2013,yt5,goal,46380,46405,25
2014,yt5,pass,46570,46611,41
2015,yt5,pass,46636,46671,35
2016,yt5,pass,46791,46817,26
2017,yt5,pass,46932,46961,29
2018,yt5,pass,47101,47122,21
2019,yt5,pass,47127,47154,27
2020,yt5,goal,47152,47184,32
2021,yt5,tackle,48094,48134,40
2022,yt5,pass,48164,48198,34
2023,yt5,pass,48488,48523,35
2024,yt5,pass,48548,48583,35
2025,yt5,pass,48608,48634,26
2026,yt5,save,48644,48660,16
2027,yt5,pass,48770,48802,32
2028,yt5,save,49047,49102,55
2029,yt5,save,49656,49670,14
2031,yt5,pass,50060,50085,25
2032,yt5,tackle,50335,50355,20
2033,yt5,pass,50805,50850,45
2034,yt5,save,51030,51075,45
2035,yt5,pass,51085,51134,49
2036,yt5,save,51134,51169,35
2037,yt5,pass,51199,51234,35
2038,yt5,pass,51424,51454,30
2039,yt5,goal,51939,51972,33
2040,yt5,pass,52074,52119,45
2041,yt5,pass,52144,52179,35
2042,yt5,pass,52324,52376,52
2043,yt5,pass,52374,52411,37
2044,yt5,pass,52566,52596,30
2045,yt5,pass,52851,52901,50
2046,yt5,pass,52899,52926,27
2048,yt5,pass,53078,53105,27
2049,yt5,tackle,53359,53379,20
2050,yt5,tackle,53409,53436,27
2051,yt5,pass,53606,53650,44
2053,yt5,pass,53827,53857,30
2054,yt5,pass,54052,54108,56
2055,yt5,save,54173,54193,20
2056,yt5,pass,54361,54398,37
2059,yt5,pass,54572,54609,37
2060,yt5,pass,55064,55083,19
2061,yt5,pass,55193,55228,35
2062,yt5,pass,55398,55428,30
2063,yt5,pass,56023,56050,27
2064,yt5,pass,57115,57153,38
2066,yt5,pass,57302,57329,27
2067,yt5,pass,57367,57403,36
2068,yt5,pass,57638,57664,26
2069,yt5,save,57709,57720,11
2070,yt5,pass,57890,57917,27
2071,yt5,pass,57957,57997,40
2072,yt5,pass,58212,58249,37
2073,yt5,pass,58479,58506,27
2074,yt5,pass,58696,58737,41
2076,yt5,pass,63725,63760,35
2077,yt5,pass,63790,63825,35
2078,yt5,pass,63855,63885,30
2079,yt5,pass,64005,64032,27
2080,yt5,pass,64342,64377,35
2081,yt5,pass,64402,64432,30
2082,yt5,pass,64702,64737,35
2083,yt5,pass,64962,65004,42
2084,yt5,pass,65004,65055,51
2085,yt5,save,65080,65095,15
2086,yt5,pass,65475,65507,32
2088,yt5,pass,66096,66126,30
2089,yt5,pass,66181,66207,26
2090,yt5,pass,66581,66606,25
2091,yt5,save,67426,67453,27
2092,yt5,pass,67618,67643,25
2093,yt5,pass,67733,67768,35
2094,yt5,pass,67863,67888,25
2095,yt5,pass,67908,67926,18
2096,yt5,pass,68156,68191,35
2097,yt5,pass,68226,68240,14
2098,yt5,pass,68264,68288,24
2099,yt5,goal,68285,68314,29
2100,yt5,pass,68629,68653,24
2101,yt5,pass,69260,69285,25
2102,yt5,pass,69340,69357,17
2103,yt5,pass,69407,69437,30
2104,yt5,tackle,70018,70038,20
2105,yt5,pass,70196,70236,40
2106,yt5,pass,70441,70479,38
2107,yt5,tackle,70479,70491,12
2109,yt5,pass,71097,71135,38
2110,yt5,pass,71145,71190,45
2111,yt5,pass,71295,71342,47
2112,yt5,goal,71517,71537,20
2113,yt5,pass,71742,71772,30
2114,yt5,tackle,71927,71947,20
2115,yt5,tackle,72007,72027,20
2116,yt5,pass,72142,72169,27
2117,yt5,pass,72799,72819,20
2118,yt5,tackle,72869,72879,10
2120,yt5,pass,73185,73235,50
2121,yt5,pass,73395,73435,40
2122,yt5,pass,73445,73472,27
2123,yt5,goal,73472,73507,35
2124,yt5,pass,73822,73872,50
2125,yt5,tackle,73892,73909,17
2126,yt5,pass,74294,74341,47
2127,yt5,goal,74901,74956,55
2128,yt5,pass,75141,75176,35
2129,yt5,pass,75556,75588,32
2131,yt5,goal,75688,75718,30
2133,yt5,pass,76903,76924,21
2134,yt5,save,76949,76969,20
2135,yt5,pass,77069,77099,30
2136,yt5,tackle,77124,77134,10
2137,yt5,save,77129,77144,15
2138,yt5,save,77169,77189,20
2139,yt5,save,77264,77294,30
2140,yt5,goal,77359,77404,45
2141,yt5,pass,78399,78419,20
2142,yt5,pass,78599,78639,40
2144,yt5,tackle,79224,79239,15
2145,yt5,tackle,79759,79794,35
2146,yt5,save,80069,80094,25
2147,yt5,tackle,80279,80304,25
2148,yt5,save,80334,80354,20
2149,yt5,goal,80359,80384,25
2151,yt5,pass,80931,80971,40
2154,yt5,pass,81958,81993,35
2156,yt5,pass,82785,82821,36
2157,yt5,pass,83126,83156,30
2158,yt5,pass,83161,83183,22
2159,yt5,pass,83243,83281,38
2160,yt5,pass,83291,83328,37
2161,yt5,pass,84103,84194,91
2162,yt5,goal,84454,84534,80
2163,yt5,pass,84724,84755,31
2164,yt5,pass,84945,84980,35
2165,yt5,pass,85075,85130,55
2166,yt5,pass,85660,85695,35
2168,yt5,pass,85755,85785,30
2169,yt5,tackle,85905,85925,20
2170,yt5,pass,86035,86049,14
2171,yt5,pass,86079,86125,46
2172,yt5,pass,86122,86147,25
2173,yt5,pass,86202,86251,49
2174,yt5,pass,86316,86369,53
2175,yt5,pass,86459,86475,16
2176,yt5,pass,86575,86607,32
2177,yt5,save,86602,86613,11
2178,yt5,pass,86958,86991,33
2179,yt5,pass,87251,87280,29
2180,yt5,pass,87330,87367,37
2181,yt5,goal,87364,87384,20
2182,yt5,pass,87589,87608,19
2183,yt5,tackle,87943,87954,11
2184,yt5,pass,88299,88322,23
2185,yt5,pass,88318,88344,26
2186,yt5,save,88342,88369,27
2187,yt5,pass,88519,88554,35
2188,yt5,pass,88629,88656,27
2189,yt5,save,88671,88686,15
2190,yt5,pass,89065,89093,28
2191,yt5,pass,89241,89273,32
2192,yt5,pass,89428,89458,30
2193,yt5,tackle,89513,89548,35
2194,yt5,pass,90000,90021,21
2195,yt5,pass,90096,90128,32
2196,yt5,save,90124,90143,19
2198,yt5,pass,90306,90362,56
2199,yt5,save,90397,90434,37
2200,yt5,pass,90544,90575,31
2201,yt5,goal,90572,90591,19
2202,yt5,pass,91041,91084,43
2203,yt5,pass,91094,91138,44
2204,yt5,save,91163,91186,23
2205,yt5,tackle,91301,91330,29
2206,yt5,pass,91385,91406,21
2207,yt5,pass,91402,91429,27
2208,yt5,goal,91427,91449,22
2209,yt5,pass,91604,91631,27
2210,yt5,pass,91626,91677,51
2211,yt5,goal,91676,91727,51
2213,yt5,pass,93074,93122,48
2214,yt5,tackle,93238,93273,35
2215,yt5,pass,93283,93323,40
2216,yt5,pass,93683,93693,10
2217,yt5,save,93845,93865,20
2218,yt5,pass,94620,94642,22
2221,yt5,pass,96812,96833,21
2222,yt5,pass,96908,96955,47
2223,yt5,goal,97065,97094,29
2224,yt5,pass,97243,97272,29
2225,yt5,pass,97367,97392,25
2226,yt5,pass,97407,97438,31
2227,yt5,pass,97433,97468,35
2228,yt5,save,97806,97831,25
2229,yt5,pass,97876,97907,31
2230,yt5,tackle,98751,98780,29
2231,yt5,pass,98952,98964,12
2232,yt5,pass,99024,99056,32
2233,yt5,pass,99431,99466,35
2234,yt5,pass,99461,99496,35
2235,yt5,pass,99606,99640,34
2238,yt5,goal,99810,99832,22
2239,yt5,pass,100047,100092,45
2240,yt5,pass,100197,100228,31
2241,yt5,pass,100308,100345,37
2243,yt5,pass,100450,100495,45
2244,yt5,tackle,100515,100529,14
2245,yt5,pass,100604,100652,48
2246,yt5,pass,100732,100770,38
2248,yt5,pass,101147,101177,30
2249,yt5,pass,101202,101233,31
2250,yt5,pass,101228,101268,40
2251,yt5,pass,101283,101327,44
2252,yt5,pass,101732,101752,20
2254,yt5,pass,102190,102200,10
2255,yt5,tackle,102860,102890,30
2256,yt5,goal,102930,102962,32
2257,yt3,pass,95,135,40
2258,yt3,pass,130,167,37
2259,yt3,pass,312,362,50
2260,yt3,goal,532,572,40
2262,yt3,pass,1152,1202,50
2264,yt3,pass,1382,1467,85
2265,yt3,save,1887,1904,17
2266,yt3,pass,2524,2565,41
2267,yt3,pass,2665,2715,50
2268,yt3,pass,2730,2785,55
2269,yt3,tackle,2845,2859,14
2270,yt3,pass,3174,3209,35
2271,yt3,pass,3579,3619,40
2272,yt3,pass,3924,3969,45
2273,yt3,pass,3979,4024,45
2274,yt3,pass,4314,4358,44
2275,yt3,pass,5063,5108,45
2277,yt3,pass,5678,5753,75
2278,yt3,pass,5969,5999,30
2281,yt3,pass,6989,7034,45
2282,yt3,pass,7544,7584,40
2284,yt3,pass,7859,7899,40
2285,yt3,pass,8244,8284,40
2286,yt3,pass,8304,8340,36
2288,yt3,save,10247,10268,21
2289,yt3,pass,10373,10408,35
2290,yt3,pass,11191,11236,45
2291,yt3,pass,11251,11296,45
2292,yt3,pass,11721,11756,35
2293,yt3,pass,11992,12043,51
2294,yt3,goal,12042,12077,35
2295,yt3,pass,12637,12677,40
2296,yt3,pass,13412,13467,55
2297,yt3,pass,14527,14559,32
2298,yt3,pass,14634,14689,55
2301,yt3,goal,14815,14845,30
2302,yt3,pass,15290,15325,35
2303,yt3,pass,15470,15530,60
2304,yt3,pass,15800,15853,53
2305,yt3,pass,15925,15970,45
2306,yt3,pass,16810,16860,50
2308,yt3,pass,17215,17273,58
2309,yt3,pass,17413,17448,35
2311,yt3,tackle,17629,17654,25
2312,yt3,pass,17903,17953,50
2313,yt3,pass,18623,18693,70
2314,yt3,pass,18763,18813,50
2315,yt3,pass,19153,19188,35
2316,yt3,pass,19278,19333,55
2317,yt3,pass,20142,20177,35
2318,yt3,pass,20282,20317,35
2319,yt3,pass,20342,20362,20
2320,yt3,pass,20575,20597,22
2321,yt3,pass,21465,21501,36
2322,yt3,pass,21531,21554,23
2323,yt3,pass,21614,21668,54
2324,yt3,tackle,21658,21674,16
2325,yt3,pass,22469,22519,50
2326,yt3,pass,22739,22776,37
2327,yt3,pass,22771,22801,30
2330,yt3,pass,24489,24524,35
2331,yt3,tackle,24739,24774,35
2332,yt3,pass,24999,25017,18
2333,yt3,pass,25082,25107,25
2334,yt3,pass,25127,25187,60
2335,yt3,pass,25212,25257,45
2336,yt3,pass,25252,25287,35
2337,yt3,pass,25462,25487,25
2338,yt3,pass,25837,25874,37
2339,yt3,pass,25939,25974,35
2340,yt3,pass,26524,26570,46
2341,yt3,pass,26955,26992,37
2342,yt3,pass,26987,27052,65
2343,yt3,pass,27467,27502,35
2344,yt3,pass,27587,27637,50
2346,yt3,pass,28127,28178,51
2347,yt3,pass,29393,29453,60
2348,yt3,pass,30093,30143,50
2349,yt3,tackle,30643,30654,11
2350,yt3,pass,31039,31074,35
2351,yt3,pass,31129,31200,71
2352,yt3,pass,31195,31225,30
2353,yt3,pass,31545,31580,35
2354,yt3,goal,31660,31685,25
2355,yt3,pass,32150,32190,40
2356,yt3,pass,32355,32400,45
2357,yt3,pass,32495,32530,35
2358,yt3,pass,32590,32625,35
2360,yt3,pass,33515,33560,45
2362,yt3,pass,33713,33763,50
2364,yt3,pass,34459,34494,35
2367,yt3,pass,36099,36136,37
2368,yt3,pass,36931,36986,55
2370,yt3,pass,37341,37401,60
2371,yt3,pass,37486,37563,77
2372,yt3,pass,37763,37827,64
2374,yt3,pass,38347,38394,47
2375,yt3,pass,38392,38410,18
2376,yt3,pass,39030,39069,39
2377,yt3,pass,39309,39344,35
2378,yt3,pass,39599,39634,35
2379,yt3,save,39742,39772,30
2380,yt3,pass,40342,40382,40
2381,yt3,pass,40457,40498,41
2383,yt3,pass,40833,40923,90
2384,yt3,pass,40988,41038,50
2385,yt3,pass,41033,41110,77
2386,yt3,pass,41395,41460,65
2387,yt3,pass,41455,41511,56
2388,yt3,pass,42076,42131,55
2389,yt3,pass,42166,42196,30
2390,yt3,tackle,42311,42341,30
2391,yt3,goal,42381,42406,25
2392,yt3,pass,42706,42781,75
2394,yt3,pass,43316,43366,50
2395,yt3,pass,43391,43421,30
2396,yt3,pass,43418,43462,44
2398,yt3,pass,43912,43950,38
2399,yt3,pass,43945,43985,40
2400,yt3,pass,44240,44296,56
2401,yt3,pass,44311,44339,28
2402,yt3,pass,44335,44382,47
2403,yt3,pass,44991,45016,25
2404,yt3,pass,45511,45552,41
2405,yt3,pass,45717,45754,37
2406,yt3,pass,46599,46628,29
2407,yt3,save,46813,46878,65
2408,yt3,tackle,47548,47573,25
2409,yt3,pass,48878,48918,40
2410,yt3,pass,48995,49041,46
2412,yt3,pass,49801,49834,33
2414,yt3,tackle,49956,49991,35
2415,yt3,pass,50706,50771,65
2417,yt3,pass,51737,51777,40
2418,yt3,pass,52122,52171,49
2419,yt3,pass,52169,52216,47
2420,yt3,pass,52836,52881,45
2421,yt3,pass,52946,53001,55
2422,yt3,pass,53016,53056,40
2423,yt3,pass,53171,53221,50
2424,yt3,pass,53271,53316,45
2427,yt3,pass,53846,53886,40
2429,yt3,goal,54070,54098,28
2431,yt3,pass,54658,54693,35
2432,yt3,pass,54868,54923,55
2433,yt3,tackle,54963,54983,20
2434,yt3,pass,56123,56158,35
2435,yt3,pass,56168,56198,30
2436,yt3,pass,56283,56333,50
2437,yt3,pass,56528,56543,15
2438,yt3,pass,56648,56688,40
2439,yt3,pass,57048,57091,43
2440,yt3,pass,57351,57397,46
2441,yt3,save,57395,57413,18
2442,yt3,pass,57818,57863,45
2443,yt3,pass,58223,58278,55
2445,yt3,pass,59208,59256,48
2446,yt3,tackle,59361,59371,10
2447,yt3,pass,59536,59605,69
2448,yt3,pass,59800,59840,40
2449,yt3,pass,59882,59913,31
2451,yt3,pass,61193,61238,45
2452,yt3,pass,61298,61337,39
2453,yt3,save,61333,61372,39
2454,yt3,pass,61977,62070,93
2455,yt3,pass,62120,62160,40
2456,yt3,goal,62190,62225,35
2457,yt3,pass,62700,62735,35
2458,yt3,pass,62775,62820,45
2459,yt3,pass,63080,63115,35
2460,yt3,pass,63355,63400,45
2462,yt3,pass,63475,63500,25
2463,yt3,tackle,63520,63545,25
2465,yt3,pass,63890,63950,60
2466,yt3,pass,64600,64635,35
2467,yt3,pass,65175,65240,65
2468,yt3,pass,65270,65325,55
2469,yt3,pass,65545,65580,35
2470,yt3,pass,65625,65650,25
2471,yt3,pass,65710,65753,43
2472,yt3,pass,65813,65838,25
2474,yt3,pass,66471,66511,40
2475,yt3,pass,66536,66581,45
2476,yt3,pass,66681,66738,57
2477,yt3,pass,67143,67188,45
2478,yt3,goal,67188,67228,40
2479,yt3,pass,67343,67428,85
2480,yt3,pass,67568,67623,55
2481,yt3,pass,67950,67977,27
2482,yt3,pass,70392,70432,40
2483,yt3,goal,70784,70824,40
2484,vid1,none,375,430,55
2485,vid1,none,432,487,55
2486,vid1,none,659,707,48
2487,vid1,none,709,757,48
2488,vid1,none,1101,1156,55
2489,vid1,none,1158,1213,55
2490,vid1,none,1949,2004,55
2491,vid1,none,2006,2061,55
2492,vid1,none,2801,2856,55
2494,vid1,none,3003,3039,36
2495,vid1,none,3041,3077,36
2496,vid1,none,3536,3591,55
2497,vid1,none,3977,4032,55
2498,vid1,none,4160,4208,48
2499,vid1,none,4210,4258,48
2500,vid1,none,4846,4901,55
2501,vid1,none,4903,4958,55
2503,vid1,none,5538,5593,55
2504,vid1,none,5703,5758,55
2505,vid1,none,5760,5815,55
2507,vid1,none,5943,5991,48
2509,vid1,none,6265,6320,55
2510,vid1,none,6322,6377,55
2511,vid1,none,6862,6917,55
2512,vid1,none,6970,7025,55
2515,vid1,none,7219,7274,55
2516,vid1,none,7506,7561,55
2517,vid1,none,7563,7618,55
2519,vid1,none,7807,7862,55
2520,vid1,none,8034,8089,55
2521,vid1,none,8243,8298,55
2522,vid1,none,8300,8355,55
2526,vid1,none,9160,9215,55
2527,vid1,none,9217,9272,55
2528,vid1,none,10049,10104,55
2529,vid1,none,10106,10161,55
2530,vid1,none,10683,10738,55
2531,vid1,none,10740,10795,55
2534,vid1,none,12652,12707,55
2535,vid1,none,12709,12764,55
2537,vid1,none,13223,13278,55
2538,vid1,none,13280,13335,55
2539,vid1,none,13509,13557,48
2540,vid1,none,13559,13607,48
2541,vid1,none,13886,13941,55
2542,vid1,none,13943,13998,55
2543,vid1,none,14624,14679,55
2544,vid1,none,14681,14736,55
2545,vid1,none,15425,15480,55
2546,vid1,none,15482,15537,55
2547,vid1,none,16241,16270,29
2548,vid1,none,16318,16373,55
2549,vid1,none,16375,16430,55
2550,vid1,none,17406,17461,55
2551,vid1,none,17463,17518,55
2552,vid1,none,17694,17749,55
2553,vid1,none,17751,17806,55
2554,vid1,none,18529,18565,36
2555,vid1,none,18567,18603,36
2556,vid1,none,18732,18787,55
2557,vid1,none,18789,18844,55
2558,vid1,none,21229,21277,48
2559,vid1,none,21279,21327,48
2562,vid1,none,22191,22246,55
2563,vid1,none,22248,22303,55
2564,vid1,none,23273,23328,55
2565,vid1,none,23330,23385,55
2566,vid1,none,23641,23696,55
2568,vid1,none,23817,23872,55
2569,vid1,none,23874,23929,55
2570,vid1,none,24008,24063,55
2574,vid1,none,25712,25767,55
2575,vid1,none,25769,25824,55
2576,vid1,none,28618,28647,29
2577,vid1,none,28649,28678,29
2578,vid1,none,30003,30058,55
2579,vid1,none,30060,30115,55
2581,vid1,none,31051,31106,55
2582,vid1,none,32774,32829,55
2583,vid1,none,32902,32931,29
2584,vid1,none,32933,32962,29
2586,vid1,none,33877,33932,55
2588,vid1,none,34867,34903,36
2589,vid1,none,35585,35640,55
2590,vid1,none,35642,35697,55
2592,vid1,none,36632,36687,55
2593,vid1,none,39878,39914,36
2594,vid1,none,39916,39952,36
2595,vid1,none,40595,40650,55
2597,vid1,none,41397,41452,55
2598,vid1,none,41454,41509,55
2599,vid1,none,44616,44671,55
2600,vid1,none,44747,44802,55
2601,vid1,none,44804,44859,55
2603,vid1,none,46738,46786,48
2604,vid1,none,46991,47046,55
2605,vid1,none,47048,47103,55
2606,vid1,none,47783,47831,48
2608,vid1,none,47947,48002,55
2609,vid1,none,49397,49445,48
2610,vid1,none,49447,49495,48
2612,vid1,none,50846,50894,48
2613,vid1,none,51001,51056,55
2614,vid1,none,51058,51113,55
2615,vid1,none,51334,51382,48
2616,vid1,none,51384,51432,48
2617,vid1,none,51825,51873,48
2618,vid1,none,51875,51923,48
2619,vid1,none,52237,52292,55
2620,vid1,none,52294,52349,55
2621,vid1,none,54251,54280,29
2622,vid1,none,54282,54311,29
2623,vid1,none,54705,54760,55
2624,vid1,none,54762,54817,55
2625,vid2,none,734,782,48
2626,vid2,none,960,989,29
2627,vid2,none,991,1020,29
2628,vid2,none,1397,1452,55
2629,vid2,none,1454,1509,55
2630,vid2,none,2242,2290,48
2631,vid2,none,2292,2340,48
2632,vid2,none,2889,2944,55
2633,vid2,none,2946,3001,55
2634,vid2,none,3521,3576,55
2635,vid2,none,3578,3633,55
2636,vid2,none,8920,8975,55
2637,vid2,none,9034,9089,55
2638,vid2,none,9091,9146,55
2639,vid2,none,10189,10244,55
2640,vid2,none,10246,10301,55
2641,vid2,none,13320,13375,55
2642,vid2,none,13377,13432,55
2644,vid2,none,14359,14414,55
2645,vid2,none,15641,15696,55
2646,vid2,none,15698,15753,55
2647,vid2,none,16078,16133,55
2648,vid2,none,16224,16279,55
2649,vid2,none,16281,16336,55
2650,vid2,none,17090,17119,29
2651,vid2,none,17121,17150,29
2652,vid2,none,17272,17327,55
2654,vid2,none,17455,17510,55
2655,vid2,none,17709,17738,29
2656,vid2,none,17740,17769,29
2657,vid2,none,17946,18001,55
2658,vid2,none,18003,18058,55
2660,vid2,none,18389,18437,48
2661,vid2,none,19188,19243,55
2662,vid2,none,19245,19300,55
2663,vid2,none,20491,20546,55
2665,vid2,none,22697,22752,55
2666,vid2,none,22754,22809,55
2667,vid2,none,23387,23435,48
2669,vid2,none,23683,23738,55
2670,vid2,none,23740,23795,55
2671,vid2,none,26345,26400,55
2672,vid2,none,26402,26457,55
2673,vid2,none,27791,27846,55
2674,vid2,none,27848,27903,55
2675,vid2,none,31987,32016,29
2676,vid2,none,32018,32047,29
2677,vid2,none,35228,35283,55
2678,vid2,none,35285,35340,55
2679,vid1,none,375,430,55
2680,vid1,none,432,487,55
2681,vid1,none,659,707,48
2682,vid1,none,709,757,48
2683,vid1,none,1101,1156,55
2685,vid1,none,1949,2004,55
2686,vid1,none,2006,2061,55
2687,vid1,none,2801,2856,55
2688,vid1,none,2858,2913,55
2689,vid1,none,3003,3039,36
2690,vid1,none,3041,3077,36
2691,vid1,none,3536,3591,55
2692,vid1,none,3977,4032,55
2693,vid1,none,4160,4208,48
2694,vid1,none,4210,4258,48
2695,vid1,none,4846,4901,55
2696,vid1,none,4903,4958,55
2697,vid1,none,5481,5536,55
2698,vid1,none,5538,5593,55
2699,vid1,none,5703,5758,55
2700,vid1,none,5760,5815,55
2701,vid1,none,5893,5941,48
2702,vid1,none,5943,5991,48
2703,vid1,none,6125,6180,55
2704,vid1,none,6265,6320,55
2705,vid1,none,6322,6377,55
2706,vid1,none,6862,6917,55
2707,vid1,none,6970,7025,55
2709,vid1,none,7162,7217,55
2710,vid1,none,7219,7274,55
2711,vid1,none,7506,7561,55
2712,vid1,none,7563,7618,55
2713,vid1,none,7750,7805,55
2714,vid1,none,7807,7862,55
2715,vid1,none,8034,8089,55
2716,vid1,none,8243,8298,55
2717,vid1,none,8300,8355,55
2718,vid1,none,8398,8427,29
2719,vid1,none,8429,8458,29
2720,vid1,none,8841,8877,36
2721,vid1,none,9160,9215,55
2722,vid1,none,9217,9272,55
2723,vid1,none,10049,10104,55
2724,vid1,none,10106,10161,55
2725,vid1,none,10683,10738,55
2726,vid1,none,10740,10795,55
2727,vid1,none,12227,12282,55
2728,vid1,none,12284,12339,55
2729,vid1,none,12652,12707,55
2730,vid1,none,12709,12764,55
2731,vid1,none,13092,13147,55
2732,vid1,none,13223,13278,55
2733,vid1,none,13280,13335,55
2734,vid1,none,13509,13557,48
2735,vid1,none,13559,13607,48
2736,vid1,none,13886,13941,55
2737,vid1,none,13943,13998,55
2738,vid1,none,14624,14679,55
2739,vid1,none,14681,14736,55
2740,vid1,none,15425,15480,55
2741,vid1,none,15482,15537,55
2742,vid1,none,16241,16270,29
2743,vid1,none,16318,16373,55
2744,vid1,none,16375,16430,55
2745,vid1,none,17406,17461,55
2746,vid1,none,17463,17518,55
2747,vid1,none,17694,17749,55
2748,vid1,none,17751,17806,55
2749,vid1,none,18529,18565,36
2750,vid1,none,18567,18603,36
2751,vid1,none,18732,18787,55
2752,vid1,none,18789,18844,55
2753,vid1,none,21229,21277,48
2754,vid1,none,21279,21327,48
2756,vid1,none,21452,21507,55
2757,vid1,none,22191,22246,55
2758,vid1,none,22248,22303,55
2759,vid1,none,23273,23328,55
2762,vid1,none,23698,23753,55
2763,vid1,none,23817,23872,55
2764,vid1,none,23874,23929,55
2765,vid1,none,24008,24063,55
2766,vid1,none,24065,24120,55
2767,vid1,none,24255,24310,55
2768,vid1,none,24312,24367,55
2769,vid1,none,25712,25767,55
2770,vid1,none,25769,25824,55
2772,vid1,none,28649,28678,29
2773,vid1,none,30003,30058,55
2774,vid1,none,30060,30115,55
2776,vid1,none,31051,31106,55
2777,vid1,none,32774,32829,55
2778,vid1,none,32902,32931,29
2779,vid1,none,32933,32962,29
2780,vid1,none,33820,33875,55
2781,vid1,none,33877,33932,55
2782,vid1,none,34829,34865,36
2783,vid1,none,34867,34903,36
2784,vid1,none,35585,35640,55
2785,vid1,none,35642,35697,55
2786,vid1,none,36575,36630,55
2788,vid1,none,39878,39914,36
2789,vid1,none,39916,39952,36
2790,vid1,none,40595,40650,55
2791,vid1,none,40652,40707,55
2792,vid1,none,41397,41452,55
2793,vid1,none,41454,41509,55
2794,vid1,none,44616,44671,55
2795,vid1,none,44747,44802,55
2796,vid1,none,44804,44859,55
2797,vid1,none,46688,46736,48
2798,vid1,none,46738,46786,48
2799,vid1,none,46991,47046,55
2800,vid1,none,47048,47103,55
2801,vid1,none,47783,47831,48
2804,vid1,none,49397,49445,48
2805,vid1,none,49447,49495,48
2807,vid1,none,50846,50894,48
2808,vid1,none,51001,51056,55
2809,vid1,none,51058,51113,55
2810,vid1,none,51334,51382,48
2811,vid1,none,51384,51432,48
2812,vid1,none,51825,51873,48
2813,vid1,none,51875,51923,48
2814,vid1,none,52237,52292,55
2815,vid1,none,52294,52349,55
2816,vid1,none,54251,54280,29
2817,vid1,none,54282,54311,29
2818,vid1,none,54705,54760,55
2820,vid2,none,734,782,48
2821,vid2,none,960,989,29
2822,vid2,none,991,1020,29
2823,vid2,none,1397,1452,55
2824,vid2,none,1454,1509,55
2825,vid2,none,2242,2290,48
2827,vid2,none,2889,2944,55
2828,vid2,none,2946,3001,55
2829,vid2,none,3521,3576,55
2830,vid2,none,3578,3633,55
2831,vid2,none,8920,8975,55
2832,vid2,none,9034,9089,55
2833,vid2,none,9091,9146,55
2835,vid2,none,10246,10301,55
2836,vid2,none,13320,13375,55
2837,vid2,none,13377,13432,55
2838,vid2,none,14302,14357,55
2839,vid2,none,14359,14414,55
2841,vid2,none,15698,15753,55
2842,vid2,none,16078,16133,55
2844,vid2,none,16281,16336,55
2845,vid2,none,17090,17119,29
2847,vid2,none,17272,17327,55
2848,vid2,none,17398,17453,55
2849,vid2,none,17455,17510,55
2850,vid2,none,17709,17738,29
2852,vid2,none,17946,18001,55
2853,vid2,none,18003,18058,55
2856,vid2,none,19188,19243,55
2857,vid2,none,19245,19300,55
2858,vid2,none,20491,20546,55
2859,vid2,none,20548,20603,55
2860,vid2,none,22697,22752,55
2861,vid2,none,22754,22809,55
2862,vid2,none,23387,23435,48
2863,vid2,none,23437,23485,48
2864,vid2,none,23683,23738,55
2865,vid2,none,23740,23795,55
2866,vid2,none,26345,26400,55
2869,vid2,none,27848,27903,55
2871,vid2,none,32018,32047,29
2872,vid2,none,35228,35283,55
2873,vid2,none,35285,35340,55
2874,vid1,none,375,430,55
2875,vid1,none,432,487,55
2876,vid1,none,659,707,48
2877,vid1,none,709,757,48
2878,vid1,none,1101,1156,55
2879,vid1,none,1158,1213,55
2880,vid1,none,1949,2004,55
2883,vid1,none,2858,2913,55
2884,vid1,none,3003,3039,36
2885,vid1,none,3041,3077,36
2886,vid1,none,3536,3591,55
2887,vid1,none,3977,4032,55
2888,vid1,none,4160,4208,48
2889,vid1,none,4210,4258,48
2890,vid1,none,4846,4901,55
2892,vid1,none,5481,5536,55
2894,vid1,none,5703,5758,55
2895,vid1,none,5760,5815,55
2896,vid1,none,5893,5941,48
2897,vid1,none,5943,5991,48
2898,vid1,none,6125,6180,55
2899,vid1,none,6265,6320,55
2900,vid1,none,6322,6377,55
2901,vid1,none,6862,6917,55
2902,vid1,none,6970,7025,55
2904,vid1,none,7162,7217,55
2905,vid1,none,7219,7274,55
2906,vid1,none,7506,7561,55
2907,vid1,none,7563,7618,55
2908,vid1,none,7750,7805,55
2909,vid1,none,7807,7862,55
2911,vid1,none,8243,8298,55
2912,vid1,none,8300,8355,55
2913,vid1,none,8398,8427,29
2914,vid1,none,8429,8458,29
2915,vid1,none,8841,8877,36
2916,vid1,none,9160,9215,55
2919,vid1,none,10106,10161,55
2921,vid1,none,10740,10795,55
2922,vid1,none,12227,12282,55
2923,vid1,none,12284,12339,55
2924,vid1,none,12652,12707,55
2925,vid1,none,12709,12764,55
2926,vid1,none,13092,13147,55
2927,vid1,none,13223,13278,55
2928,vid1,none,13280,13335,55
2929,vid1,none,13509,13557,48
2930,vid1,none,13559,13607,48
2931,vid1,none,13886,13941,55
2932,vid1,none,13943,13998,55
2933,vid1,none,14624,14679,55
2935,vid1,none,15425,15480,55
2936,vid1,none,15482,15537,55
2937,vid1,none,16241,16270,29
2938,vid1,none,16318,16373,55
2939,vid1,none,16375,16430,55
2940,vid1,none,17406,17461,55
2941,vid1,none,17463,17518,55
2942,vid1,none,17694,17749,55
2943,vid1,none,17751,17806,55
2944,vid1,none,18529,18565,36
2946,vid1,none,18732,18787,55
2947,vid1,none,18789,18844,55
2948,vid1,none,21229,21277,48
2949,vid1,none,21279,21327,48
2950,vid1,none,21395,21450,55
2951,vid1,none,21452,21507,55
2952,vid1,none,22191,22246,55
2954,vid1,none,23273,23328,55
2955,vid1,none,23330,23385,55
2957,vid1,none,23698,23753,55
2958,vid1,none,23817,23872,55
2959,vid1,none,23874,23929,55
2960,vid1,none,24008,24063,55
2961,vid1,none,24065,24120,55
2962,vid1,none,24255,24310,55
2965,vid1,none,25769,25824,55
2966,vid1,none,28618,28647,29
2967,vid1,none,28649,28678,29
2968,vid1,none,30003,30058,55
2969,vid1,none,30060,30115,55
2970,vid1,none,30994,31049,55
2971,vid1,none,31051,31106,55
2972,vid1,none,32774,32829,55
2973,vid1,none,32902,32931,29
2975,vid1,none,33820,33875,55
2976,vid1,none,33877,33932,55
2977,vid1,none,34829,34865,36
2978,vid1,none,34867,34903,36
2979,vid1,none,35585,35640,55
2982,vid1,none,36632,36687,55
2983,vid1,none,39878,39914,36
2985,vid1,none,40595,40650,55
2986,vid1,none,40652,40707,55
2988,vid1,none,41454,41509,55
2989,vid1,none,44616,44671,55
2992,vid1,none,46688,46736,48
2993,vid1,none,46738,46786,48
2994,vid1,none,46991,47046,55
2995,vid1,none,47048,47103,55
2997,vid1,none,47890,47945,55
2998,vid1,none,47947,48002,55
2999,vid1,none,49397,49445,48
3000,vid1,none,49447,49495,48
3001,vid1,none,50796,50844,48
3002,vid1,none,50846,50894,48
3003,vid1,none,51001,51056,55
3004,vid1,none,51058,51113,55
3005,vid1,none,51334,51382,48
3006,vid1,none,51384,51432,48
3007,vid1,none,51825,51873,48
3008,vid1,none,51875,51923,48
3009,vid1,none,52237,52292,55
3011,vid1,none,54251,54280,29
3012,vid1,none,54282,54311,29
3013,vid1,none,54705,54760,55
3014,vid1,none,54762,54817,55
3015,vid2,none,734,782,48
3016,vid2,none,960,989,29
3017,vid2,none,991,1020,29
3018,vid2,none,1397,1452,55
3020,vid2,none,2242,2290,48
3021,vid2,none,2292,2340,48
3022,vid2,none,2889,2944,55
3024,vid2,none,3521,3576,55
3025,vid2,none,3578,3633,55
3026,vid2,none,8920,8975,55
3027,vid2,none,9034,9089,55
3028,vid2,none,9091,9146,55
3029,vid2,none,10189,10244,55
3030,vid2,none,10246,10301,55
3032,vid2,none,13377,13432,55
3033,vid2,none,14302,14357,55
3035,vid2,none,15641,15696,55
3036,vid2,none,15698,15753,55
3037,vid2,none,16078,16133,55
3038,vid2,none,16224,16279,55
3039,vid2,none,16281,16336,55
3040,vid2,none,17090,17119,29
3041,vid2,none,17121,17150,29
3042,vid2,none,17272,17327,55
3044,vid2,none,17455,17510,55
3046,vid2,none,17740,17769,29
3047,vid2,none,17946,18001,55
3049,vid2,none,18339,18387,48
3050,vid2,none,18389,18437,48
3051,vid2,none,19188,19243,55
3052,vid2,none,19245,19300,55
3053,vid2,none,20491,20546,55
3054,vid2,none,20548,20603,55
3055,vid2,none,22697,22752,55
3056,vid2,none,22754,22809,55
3057,vid2,none,23387,23435,48
3058,vid2,none,23437,23485,48
3059,vid2,none,23683,23738,55
3061,vid2,none,26345,26400,55
3062,vid2,none,26402,26457,55
3063,vid2,none,27791,27846,55
3064,vid2,none,27848,27903,55
3065,vid2,none,31987,32016,29
3066,vid2,none,32018,32047,29
3067,vid2,none,35228,35283,55
3068,vid2,none,35285,35340,55
3070,vid1,none,432,487,55
3071,vid1,none,659,707,48
3072,vid1,none,709,757,48
3074,vid1,none,1158,1213,55
3075,vid1,none,1949,2004,55
3076,vid1,none,2006,2061,55
3077,vid1,none,2801,2856,55
3078,vid1,none,2858,2913,55
3080,vid1,none,3041,3077,36
3082,vid1,none,3977,4032,55
3083,vid1,none,4160,4208,48
3084,vid1,none,4210,4258,48
3085,vid1,none,4846,4901,55
3086,vid1,none,4903,4958,55
3087,vid1,none,5481,5536,55
3088,vid1,none,5538,5593,55
3089,vid1,none,5703,5758,55
3090,vid1,none,5760,5815,55
3092,vid1,none,5943,5991,48
3093,vid1,none,6125,6180,55
3094,vid1,none,6265,6320,55
3096,vid1,none,6862,6917,55
3097,vid1,none,6970,7025,55
3098,vid1,none,7027,7082,55
3099,vid1,none,7162,7217,55
3100,vid1,none,7219,7274,55
3101,vid1,none,7506,7561,55
3102,vid1,none,7563,7618,55
3104,vid1,none,7807,7862,55
3106,vid1,none,8243,8298,55
3107,vid1,none,8300,8355,55
3108,vid1,none,8398,8427,29
3109,vid1,none,8429,8458,29
3110,vid1,none,8841,8877,36
3111,vid1,none,9160,9215,55
3112,vid1,none,9217,9272,55
3113,vid1,none,10049,10104,55
3114,vid1,none,10106,10161,55
3116,vid1,none,10740,10795,55
3117,vid1,none,12227,12282,55
3118,vid1,none,12284,12339,55
3119,vid1,none,12652,12707,55
3120,vid1,none,12709,12764,55
3121,vid1,none,13092,13147,55
3123,vid1,none,13280,13335,55
3124,vid1,none,13509,13557,48
3125,vid1,none,13559,13607,48
3126,vid1,none,13886,13941,55
3127,vid1,none,13943,13998,55
3128,vid1,none,14624,14679,55
3129,vid1,none,14681,14736,55
3130,vid1,none,15425,15480,55
3131,vid1,none,15482,15537,55
3132,vid1,none,16241,16270,29
3133,vid1,none,16318,16373,55
3134,vid1,none,16375,16430,55
3135,vid1,none,17406,17461,55
3138,vid1,none,17751,17806,55
3139,vid1,none,18529,18565,36
3140,vid1,none,18567,18603,36
3142,vid1,none,18789,18844,55
3143,vid1,none,21229,21277,48
3144,vid1,none,21279,21327,48
3145,vid1,none,21395,21450,55
3146,vid1,none,21452,21507,55
3147,vid1,none,22191,22246,55
3148,vid1,none,22248,22303,55
3149,vid1,none,23273,23328,55
3150,vid1,none,23330,23385,55
3152,vid1,none,23698,23753,55
3153,vid1,none,23817,23872,55
3154,vid1,none,23874,23929,55
3155,vid1,none,24008,24063,55
3156,vid1,none,24065,24120,55
3157,vid1,none,24255,24310,55
3158,vid1,none,24312,24367,55
3159,vid1,none,25712,25767,55
3161,vid1,none,28618,28647,29
3162,vid1,none,28649,28678,29
3163,vid1,none,30003,30058,55
3164,vid1,none,30060,30115,55
3165,vid1,none,30994,31049,55
3166,vid1,none,31051,31106,55
3168,vid1,none,32902,32931,29
3169,vid1,none,32933,32962,29
3170,vid1,none,33820,33875,55
3171,vid1,none,33877,33932,55
3172,vid1,none,34829,34865,36
3173,vid1,none,34867,34903,36
3174,vid1,none,35585,35640,55
3175,vid1,none,35642,35697,55
3176,vid1,none,36575,36630,55
3177,vid1,none,36632,36687,55
3178,vid1,none,39878,39914,36
3179,vid1,none,39916,39952,36
3180,vid1,none,40595,40650,55
3181,vid1,none,40652,40707,55
3182,vid1,none,41397,41452,55
3183,vid1,none,41454,41509,55
3184,vid1,none,44616,44671,55
3185,vid1,none,44747,44802,55
3186,vid1,none,44804,44859,55
3188,vid1,none,46738,46786,48
3189,vid1,none,46991,47046,55
3192,vid1,none,47890,47945,55
3193,vid1,none,47947,48002,55
3194,vid1,none,49397,49445,48
3195,vid1,none,49447,49495,48
3196,vid1,none,50796,50844,48
3197,vid1,none,50846,50894,48
3198,vid1,none,51001,51056,55
3200,vid1,none,51334,51382,48
3202,vid1,none,51825,51873,48
3203,vid1,none,51875,51923,48
3204,vid1,none,52237,52292,55
3205,vid1,none,52294,52349,55
3206,vid1,none,54251,54280,29
3207,vid1,none,54282,54311,29
3208,vid1,none,54705,54760,55
3209,vid1,none,54762,54817,55
3210,vid2,none,734,782,48
3211,vid2,none,960,989,29
3213,vid2,none,1397,1452,55
3214,vid2,none,1454,1509,55
3215,vid2,none,2242,2290,48
3217,vid2,none,2889,2944,55
3219,vid2,none,3521,3576,55
3221,vid2,none,8920,8975,55
3224,vid2,none,10189,10244,55
3226,vid2,none,13320,13375,55
3227,vid2,none,13377,13432,55
3228,vid2,none,14302,14357,55
3229,vid2,none,14359,14414,55
3230,vid2,none,15641,15696,55
3232,vid2,none,16078,16133,55
3233,vid2,none,16224,16279,55
3234,vid2,none,16281,16336,55
3235,vid2,none,17090,17119,29
3237,vid2,none,17272,17327,55
3238,vid2,none,17398,17453,55
3239,vid2,none,17455,17510,55
3240,vid2,none,17709,17738,29
3241,vid2,none,17740,17769,29
3242,vid2,none,17946,18001,55
3243,vid2,none,18003,18058,55
3244,vid2,none,18339,18387,48
3245,vid2,none,18389,18437,48
3247,vid2,none,19245,19300,55
3249,vid2,none,20548,20603,55
3250,vid2,none,22697,22752,55
3251,vid2,none,22754,22809,55
3253,vid2,none,23437,23485,48
3254,vid2,none,23683,23738,55
3255,vid2,none,23740,23795,55
3257,vid2,none,26402,26457,55
3258,vid2,none,27791,27846,55
3259,vid2,none,27848,27903,55
3260,vid2,none,31987,32016,29
3261,vid2,none,32018,32047,29
3262,vid2,none,35228,35283,55
3263,vid2,none,35285,35340,55
3264,vid1,none,375,430,55
3265,vid1,none,432,487,55
3266,vid1,none,659,707,48
3267,vid1,none,709,757,48
3268,vid1,none,1101,1156,55
3269,vid1,none,1158,1213,55
3270,vid1,none,1949,2004,55
3271,vid1,none,2006,2061,55
3272,vid1,none,2801,2856,55
3274,vid1,none,3003,3039,36
3275,vid1,none,3041,3077,36
3276,vid1,none,3536,3591,55
3277,vid1,none,3977,4032,55
3278,vid1,none,4160,4208,48
3279,vid1,none,4210,4258,48
3280,vid1,none,4846,4901,55
3281,vid1,none,4903,4958,55
3282,vid1,none,5481,5536,55
3283,vid1,none,5538,5593,55
3284,vid1,none,5703,5758,55
3285,vid1,none,5760,5815,55
3286,vid1,none,5893,5941,48
3287,vid1,none,5943,5991,48
3288,vid1,none,6125,6180,55
3289,vid1,none,6265,6320,55
3290,vid1,none,6322,6377,55
3291,vid1,none,6862,6917,55
3292,vid1,none,6970,7025,55
3293,vid1,none,7027,7082,55
3296,vid1,none,7506,7561,55
3297,vid1,none,7563,7618,55
3298,vid1,none,7750,7805,55
3299,vid1,none,7807,7862,55
3300,vid1,none,8034,8089,55
3301,vid1,none,8243,8298,55
3302,vid1,none,8300,8355,55
3303,vid1,none,8398,8427,29
3304,vid1,none,8429,8458,29
3306,vid1,none,9160,9215,55
3307,vid1,none,9217,9272,55
3308,vid1,none,10049,10104,55
3310,vid1,none,10683,10738,55
3311,vid1,none,10740,10795,55
3312,vid1,none,12227,12282,55
3313,vid1,none,12284,12339,55
3314,vid1,none,12652,12707,55
3315,vid1,none,12709,12764,55
3316,vid1,none,13092,13147,55
3317,vid1,none,13223,13278,55
3318,vid1,none,13280,13335,55
3320,vid1,none,13559,13607,48
3321,vid1,none,13886,13941,55
3322,vid1,none,13943,13998,55
3323,vid1,none,14624,14679,55
3324,vid1,none,14681,14736,55
3326,vid1,none,15482,15537,55
3328,vid1,none,16318,16373,55
3329,vid1,none,16375,16430,55
3331,vid1,none,17463,17518,55
3332,vid1,none,17694,17749,55
3333,vid1,none,17751,17806,55
3334,vid1,none,18529,18565,36
3335,vid1,none,18567,18603,36
3336,vid1,none,18732,18787,55
3337,vid1,none,18789,18844,55
3338,vid1,none,21229,21277,48
3340,vid1,none,21395,21450,55
3341,vid1,none,21452,21507,55
3342,vid1,none,22191,22246,55
3344,vid1,none,23273,23328,55
3345,vid1,none,23330,23385,55
3346,vid1,none,23641,23696,55
3347,vid1,none,23698,23753,55
3348,vid1,none,23817,23872,55
3349,vid1,none,23874,23929,55
3350,vid1,none,24008,24063,55
3351,vid1,none,24065,24120,55
3352,vid1,none,24255,24310,55
3353,vid1,none,24312,24367,55
3354,vid1,none,25712,25767,55
3355,vid1,none,25769,25824,55
3356,vid1,none,28618,28647,29
3358,vid1,none,30003,30058,55
3359,vid1,none,30060,30115,55
3360,vid1,none,30994,31049,55
3361,vid1,none,31051,31106,55
3362,vid1,none,32774,32829,55
3363,vid1,none,32902,32931,29
3365,vid1,none,33820,33875,55
3366,vid1,none,33877,33932,55
3367,vid1,none,34829,34865,36
3368,vid1,none,34867,34903,36
3369,vid1,none,35585,35640,55
3370,vid1,none,35642,35697,55
3371,vid1,none,36575,36630,55
3372,vid1,none,36632,36687,55
3373,vid1,none,39878,39914,36
3374,vid1,none,39916,39952,36
3375,vid1,none,40595,40650,55
3377,vid1,none,41397,41452,55
3378,vid1,none,41454,41509,55
3379,vid1,none,44616,44671,55
3380,vid1,none,44747,44802,55
3381,vid1,none,44804,44859,55
3383,vid1,none,46738,46786,48
3384,vid1,none,46991,47046,55
3386,vid1,none,47783,47831,48
3387,vid1,none,47890,47945,55
3388,vid1,none,47947,48002,55
3389,vid1,none,49397,49445,48
3390,vid1,none,49447,49495,48
3391,vid1,none,50796,50844,48
3392,vid1,none,50846,50894,48
3393,vid1,none,51001,51056,55
3394,vid1,none,51058,51113,55
3395,vid1,none,51334,51382,48
3397,vid1,none,51825,51873,48
3398,vid1,none,51875,51923,48
3399,vid1,none,52237,52292,55
3400,vid1,none,52294,52349,55
3402,vid1,none,54282,54311,29
3403,vid1,none,54705,54760,55
3404,vid1,none,54762,54817,55
3405,vid2,none,734,782,48
3406,vid2,none,960,989,29
3407,vid2,none,991,1020,29
3408,vid2,none,1397,1452,55
3409,vid2,none,1454,1509,55
3411,vid2,none,2292,2340,48
3412,vid2,none,2889,2944,55
3413,vid2,none,2946,3001,55
3414,vid2,none,3521,3576,55
3415,vid2,none,3578,3633,55
3416,vid2,none,8920,8975,55
3417,vid2,none,9034,9089,55
3418,vid2,none,9091,9146,55
3419,vid2,none,10189,10244,55
3420,vid2,none,10246,10301,55
3421,vid2,none,13320,13375,55
3422,vid2,none,13377,13432,55
3423,vid2,none,14302,14357,55
3425,vid2,none,15641,15696,55
3427,vid2,none,16078,16133,55
3428,vid2,none,16224,16279,55
3429,vid2,none,16281,16336,55
3430,vid2,none,17090,17119,29
3431,vid2,none,17121,17150,29
3432,vid2,none,17272,17327,55
3433,vid2,none,17398,17453,55
3434,vid2,none,17455,17510,55
3435,vid2,none,17709,17738,29
3436,vid2,none,17740,17769,29
3437,vid2,none,17946,18001,55
3438,vid2,none,18003,18058,55
3439,vid2,none,18339,18387,48
3441,vid2,none,19188,19243,55
3442,vid2,none,19245,19300,55
3444,vid2,none,20548,20603,55
3445,vid2,none,22697,22752,55
3446,vid2,none,22754,22809,55
3448,vid2,none,23437,23485,48
3449,vid2,none,23683,23738,55
3452,vid2,none,26402,26457,55
3453,vid2,none,27791,27846,55
3454,vid2,none,27848,27903,55
3456,vid2,none,32018,32047,29
3457,vid2,none,35228,35283,55
3458,vid2,none,35285,35340,55
3459,vid1,none,375,430,55
3461,vid1,none,659,707,48
3462,vid1,none,709,757,48
3463,vid1,none,1101,1156,55
3464,vid1,none,1158,1213,55
3466,vid1,none,2006,2061,55
3467,vid1,none,2801,2856,55
3468,vid1,none,2858,2913,55
3469,vid1,none,3003,3039,36
3470,vid1,none,3041,3077,36
3471,vid1,none,3536,3591,55
3473,vid1,none,4160,4208,48
3474,vid1,none,4210,4258,48
3475,vid1,none,4846,4901,55
3476,vid1,none,4903,4958,55
3477,vid1,none,5481,5536,55
3478,vid1,none,5538,5593,55
3479,vid1,none,5703,5758,55
3480,vid1,none,5760,5815,55
3481,vid1,none,5893,5941,48
3482,vid1,none,5943,5991,48
3483,vid1,none,6125,6180,55
3484,vid1,none,6265,6320,55
3486,vid1,none,6862,6917,55
3487,vid1,none,6970,7025,55
3489,vid1,none,7162,7217,55
3490,vid1,none,7219,7274,55
3491,vid1,none,7506,7561,55
3493,vid1,none,7750,7805,55
3495,vid1,none,8034,8089,55
3496,vid1,none,8243,8298,55
3497,vid1,none,8300,8355,55
3498,vid1,none,8398,8427,29
3501,vid1,none,9160,9215,55
3503,vid1,none,10049,10104,55
3504,vid1,none,10106,10161,55
3505,vid1,none,10683,10738,55
3506,vid1,none,10740,10795,55
3507,vid1,none,12227,12282,55
3508,vid1,none,12284,12339,55
3509,vid1,none,12652,12707,55
3511,vid1,none,13092,13147,55
3512,vid1,none,13223,13278,55
3513,vid1,none,13280,13335,55
3514,vid1,none,13509,13557,48
3515,vid1,none,13559,13607,48
3516,vid1,none,13886,13941,55
3517,vid1,none,13943,13998,55
3518,vid1,none,14624,14679,55
3519,vid1,none,14681,14736,55
3520,vid1,none,15425,15480,55
3522,vid1,none,16241,16270,29
3524,vid1,none,16375,16430,55
3525,vid1,none,17406,17461,55
3526,vid1,none,17463,17518,55
3527,vid1,none,17694,17749,55
3528,vid1,none,17751,17806,55
3529,vid1,none,18529,18565,36
3530,vid1,none,18567,18603,36
3531,vid1,none,18732,18787,55
3532,vid1,none,18789,18844,55
3533,vid1,none,21229,21277,48
3534,vid1,none,21279,21327,48
3535,vid1,none,21395,21450,55
3536,vid1,none,21452,21507,55
3537,vid1,none,22191,22246,55
3538,vid1,none,22248,22303,55
3539,vid1,none,23273,23328,55
3540,vid1,none,23330,23385,55
3541,vid1,none,23641,23696,55
3542,vid1,none,23698,23753,55
3543,vid1,none,23817,23872,55
3545,vid1,none,24008,24063,55
3546,vid1,none,24065,24120,55
3547,vid1,none,24255,24310,55
3548,vid1,none,24312,24367,55
3549,vid1,none,25712,25767,55
3550,vid1,none,25769,25824,55
3551,vid1,none,28618,28647,29
3552,vid1,none,28649,28678,29
3553,vid1,none,30003,30058,55
3554,vid1,none,30060,30115,55
3555,vid1,none,30994,31049,55
3556,vid1,none,31051,31106,55
3557,vid1,none,32774,32829,55
3558,vid1,none,32902,32931,29
3559,vid1,none,32933,32962,29
3560,vid1,none,33820,33875,55
3562,vid1,none,34829,34865,36
3563,vid1,none,34867,34903,36
3564,vid1,none,35585,35640,55
3565,vid1,none,35642,35697,55
3567,vid1,none,36632,36687,55
3568,vid1,none,39878,39914,36
3569,vid1,none,39916,39952,36
3570,vid1,none,40595,40650,55
3571,vid1,none,40652,40707,55
3572,vid1,none,41397,41452,55
3573,vid1,none,41454,41509,55
3576,vid1,none,44804,44859,55
3577,vid1,none,46688,46736,48
3578,vid1,none,46738,46786,48
3579,vid1,none,46991,47046,55
3582,vid1,none,47890,47945,55
3583,vid1,none,47947,48002,55
3584,vid1,none,49397,49445,48
3585,vid1,none,49447,49495,48
3586,vid1,none,50796,50844,48
3587,vid1,none,50846,50894,48
3588,vid1,none,51001,51056,55
3589,vid1,none,51058,51113,55
3590,vid1,none,51334,51382,48
3592,vid1,none,51825,51873,48
3595,vid1,none,52294,52349,55
3596,vid1,none,54251,54280,29
3597,vid1,none,54282,54311,29
3598,vid1,none,54705,54760,55
3599,vid1,none,54762,54817,55
3600,vid2,none,734,782,48
3601,vid2,none,960,989,29
3602,vid2,none,991,1020,29
3603,vid2,none,1397,1452,55
3604,vid2,none,1454,1509,55
3605,vid2,none,2242,2290,48
3606,vid2,none,2292,2340,48
3607,vid2,none,2889,2944,55
3608,vid2,none,2946,3001,55
3610,vid2,none,3578,3633,55
3611,vid2,none,8920,8975,55
3612,vid2,none,9034,9089,55
3613,vid2,none,9091,9146,55
3614,vid2,none,10189,10244,55
3615,vid2,none,10246,10301,55
3616,vid2,none,13320,13375,55
3617,vid2,none,13377,13432,55
3618,vid2,none,14302,14357,55
3619,vid2,none,14359,14414,55
3620,vid2,none,15641,15696,55
3621,vid2,none,15698,15753,55
3623,vid2,none,16224,16279,55
3624,vid2,none,16281,16336,55
3625,vid2,none,17090,17119,29
3626,vid2,none,17121,17150,29
3627,vid2,none,17272,17327,55
3628,vid2,none,17398,17453,55
3629,vid2,none,17455,17510,55
3630,vid2,none,17709,17738,29
3633,vid2,none,18003,18058,55
3635,vid2,none,18389,18437,48
3636,vid2,none,19188,19243,55
3637,vid2,none,19245,19300,55
3638,vid2,none,20491,20546,55
3639,vid2,none,20548,20603,55
3640,vid2,none,22697,22752,55
3641,vid2,none,22754,22809,55
3642,vid2,none,23387,23435,48
3643,vid2,none,23437,23485,48
3644,vid2,none,23683,23738,55
3646,vid2,none,26345,26400,55
3647,vid2,none,26402,26457,55
3648,vid2,none,27791,27846,55
3649,vid2,none,27848,27903,55
3650,vid2,none,31987,32016,29
3651,vid2,none,32018,32047,29
3652,vid2,none,35228,35283,55
3653,vid2,none,35285,35340,55
3654,vid1,none,375,430,55
3655,vid1,none,432,487,55
3656,vid1,none,659,707,48
3657,vid1,none,709,757,48
3659,vid1,none,1158,1213,55
3660,vid1,none,1949,2004,55
3661,vid1,none,2006,2061,55
3664,vid1,none,3003,3039,36
3665,vid1,none,3041,3077,36
3666,vid1,none,3536,3591,55
3667,vid1,none,3977,4032,55
3668,vid1,none,4160,4208,48
3669,vid1,none,4210,4258,48
3670,vid1,none,4846,4901,55
3671,vid1,none,4903,4958,55
3672,vid1,none,5481,5536,55
3673,vid1,none,5538,5593,55
3675,vid1,none,5760,5815,55
3676,vid1,none,5893,5941,48
3677,vid1,none,5943,5991,48
3678,vid1,none,6125,6180,55
3679,vid1,none,6265,6320,55
3680,vid1,none,6322,6377,55
3681,vid1,none,6862,6917,55
3682,vid1,none,6970,7025,55
3684,vid1,none,7162,7217,55
3685,vid1,none,7219,7274,55
3686,vid1,none,7506,7561,55
3687,vid1,none,7563,7618,55
3688,vid1,none,7750,7805,55
3689,vid1,none,7807,7862,55
3691,vid1,none,8243,8298,55
3693,vid1,none,8398,8427,29
3695,vid1,none,8841,8877,36
3696,vid1,none,9160,9215,55
3697,vid1,none,9217,9272,55
3698,vid1,none,10049,10104,55
3699,vid1,none,10106,10161,55
3700,vid1,none,10683,10738,55
3701,vid1,none,10740,10795,55
3702,vid1,none,12227,12282,55
3703,vid1,none,12284,12339,55
3704,vid1,none,12652,12707,55
3705,vid1,none,12709,12764,55
3706,vid1,none,13092,13147,55
3707,vid1,none,13223,13278,55
3708,vid1,none,13280,13335,55
3709,vid1,none,13509,13557,48
3710,vid1,none,13559,13607,48
3712,vid1,none,13943,13998,55
3713,vid1,none,14624,14679,55
3714,vid1,none,14681,14736,55
3715,vid1,none,15425,15480,55
3717,vid1,none,16241,16270,29
3718,vid1,none,16318,16373,55
3719,vid1,none,16375,16430,55
3720,vid1,none,17406,17461,55
3721,vid1,none,17463,17518,55
3722,vid1,none,17694,17749,55
3723,vid1,none,17751,17806,55
3724,vid1,none,18529,18565,36
3725,vid1,none,18567,18603,36
3726,vid1,none,18732,18787,55
3727,vid1,none,18789,18844,55
3728,vid1,none,21229,21277,48
3730,vid1,none,21395,21450,55
3731,vid1,none,21452,21507,55
3732,vid1,none,22191,22246,55
3733,vid1,none,22248,22303,55
3734,vid1,none,23273,23328,55
3735,vid1,none,23330,23385,55
3736,vid1,none,23641,23696,55
3738,vid1,none,23817,23872,55
3741,vid1,none,24065,24120,55
3742,vid1,none,24255,24310,55
3743,vid1,none,24312,24367,55
3745,vid1,none,25769,25824,55
3746,vid1,none,28618,28647,29
3747,vid1,none,28649,28678,29
3748,vid1,none,30003,30058,55
3749,vid1,none,30060,30115,55
3751,vid1,none,31051,31106,55
3753,vid1,none,32902,32931,29
3754,vid1,none,32933,32962,29
3755,vid1,none,33820,33875,55
3756,vid1,none,33877,33932,55
3759,vid1,none,35585,35640,55
3761,vid1,none,36575,36630,55
3762,vid1,none,36632,36687,55
3763,vid1,none,39878,39914,36
3764,vid1,none,39916,39952,36
3765,vid1,none,40595,40650,55
3766,vid1,none,40652,40707,55
3767,vid1,none,41397,41452,55
3768,vid1,none,41454,41509,55
3769,vid1,none,44616,44671,55
3770,vid1,none,44747,44802,55
3771,vid1,none,44804,44859,55
3772,vid1,none,46688,46736,48
3773,vid1,none,46738,46786,48
3775,vid1,none,47048,47103,55
3777,vid1,none,47890,47945,55
3778,vid1,none,47947,48002,55
3779,vid1,none,49397,49445,48
3780,vid1,none,49447,49495,48
3782,vid1,none,50846,50894,48
3783,vid1,none,51001,51056,55
3784,vid1,none,51058,51113,55
3785,vid1,none,51334,51382,48
3786,vid1,none,51384,51432,48
3787,vid1,none,51825,51873,48
3788,vid1,none,51875,51923,48
3789,vid1,none,52237,52292,55
3790,vid1,none,52294,52349,55
3791,vid1,none,54251,54280,29
3792,vid1,none,54282,54311,29
3793,vid1,none,54705,54760,55
3794,vid1,none,54762,54817,55
3795,vid2,none,734,782,48
3796,vid2,none,960,989,29
3798,vid2,none,1397,1452,55
3799,vid2,none,1454,1509,55
3800,vid2,none,2242,2290,48
3801,vid2,none,2292,2340,48
3802,vid2,none,2889,2944,55
3803,vid2,none,2946,3001,55
3804,vid2,none,3521,3576,55
3805,vid2,none,3578,3633,55
3806,vid2,none,8920,8975,55
3807,vid2,none,9034,9089,55
3808,vid2,none,9091,9146,55
3809,vid2,none,10189,10244,55
3810,vid2,none,10246,10301,55
3811,vid2,none,13320,13375,55
3812,vid2,none,13377,13432,55
3814,vid2,none,14359,14414,55
3815,vid2,none,15641,15696,55
3816,vid2,none,15698,15753,55
3817,vid2,none,16078,16133,55
3818,vid2,none,16224,16279,55
3819,vid2,none,16281,16336,55
3820,vid2,none,17090,17119,29
3823,vid2,none,17398,17453,55
3824,vid2,none,17455,17510,55
3825,vid2,none,17709,17738,29
3826,vid2,none,17740,17769,29
3827,vid2,none,17946,18001,55
3828,vid2,none,18003,18058,55
3829,vid2,none,18339,18387,48
3830,vid2,none,18389,18437,48
3831,vid2,none,19188,19243,55
3832,vid2,none,19245,19300,55
3834,vid2,none,20548,20603,55
3835,vid2,none,22697,22752,55
3836,vid2,none,22754,22809,55
3837,vid2,none,23387,23435,48
3838,vid2,none,23437,23485,48
3839,vid2,none,23683,23738,55
3840,vid2,none,23740,23795,55
3841,vid2,none,26345,26400,55
3842,vid2,none,26402,26457,55
3843,vid2,none,27791,27846,55
3844,vid2,none,27848,27903,55
3846,vid2,none,32018,32047,29
3847,vid2,none,35228,35283,55
3849,vid1,none,375,430,55
3850,vid1,none,432,487,55
3851,vid1,none,659,707,48
3852,vid1,none,709,757,48
3853,vid1,none,1101,1156,55
3854,vid1,none,1158,1213,55
3855,vid1,none,1949,2004,55
3856,vid1,none,2006,2061,55
3857,vid1,none,2801,2856,55
3858,vid1,none,2858,2913,55
3859,vid1,none,3003,3039,36
3861,vid1,none,3536,3591,55
3862,vid1,none,3977,4032,55
3863,vid1,none,4160,4208,48
3864,vid1,none,4210,4258,48
3865,vid1,none,4846,4901,55
3866,vid1,none,4903,4958,55
3867,vid1,none,5481,5536,55
3869,vid1,none,5703,5758,55
3870,vid1,none,5760,5815,55
3871,vid1,none,5893,5941,48
3872,vid1,none,5943,5991,48
3873,vid1,none,6125,6180,55
3874,vid1,none,6265,6320,55
3875,vid1,none,6322,6377,55
3876,vid1,none,6862,6917,55
3877,vid1,none,6970,7025,55
3878,vid1,none,7027,7082,55
3879,vid1,none,7162,7217,55
3880,vid1,none,7219,7274,55
3881,vid1,none,7506,7561,55
3882,vid1,none,7563,7618,55
3883,vid1,none,7750,7805,55
3884,vid1,none,7807,7862,55
3885,vid1,none,8034,8089,55
3886,vid1,none,8243,8298,55
3887,vid1,none,8300,8355,55
3888,vid1,none,8398,8427,29
3889,vid1,none,8429,8458,29
3891,vid1,none,9160,9215,55
3892,vid1,none,9217,9272,55
3893,vid1,none,10049,10104,55
3894,vid1,none,10106,10161,55
3895,vid1,none,10683,10738,55
3897,vid1,none,12227,12282,55
3898,vid1,none,12284,12339,55
3899,vid1,none,12652,12707,55
3900,vid1,none,12709,12764,55
3901,vid1,none,13092,13147,55
3902,vid1,none,13223,13278,55
3903,vid1,none,13280,13335,55
3904,vid1,none,13509,13557,48
3905,vid1,none,13559,13607,48
3906,vid1,none,13886,13941,55
3907,vid1,none,13943,13998,55
3908,vid1,none,14624,14679,55
3909,vid1,none,14681,14736,55
3910,vid1,none,15425,15480,55
3911,vid1,none,15482,15537,55
3912,vid1,none,16241,16270,29
3913,vid1,none,16318,16373,55
3914,vid1,none,16375,16430,55
3915,vid1,none,17406,17461,55
3916,vid1,none,17463,17518,55
3919,vid1,none,18529,18565,36
3920,vid1,none,18567,18603,36
3921,vid1,none,18732,18787,55
3923,vid1,none,21229,21277,48
3924,vid1,none,21279,21327,48
3925,vid1,none,21395,21450,55
3926,vid1,none,21452,21507,55
3927,vid1,none,22191,22246,55
3928,vid1,none,22248,22303,55
3929,vid1,none,23273,23328,55
3930,vid1,none,23330,23385,55
3931,vid1,none,23641,23696,55
3932,vid1,none,23698,23753,55
3933,vid1,none,23817,23872,55
3936,vid1,none,24065,24120,55
3937,vid1,none,24255,24310,55
3938,vid1,none,24312,24367,55
3939,vid1,none,25712,25767,55
3940,vid1,none,25769,25824,55
3941,vid1,none,28618,28647,29
3943,vid1,none,30003,30058,55
3944,vid1,none,30060,30115,55
3946,vid1,none,31051,31106,55
3947,vid1,none,32774,32829,55
3948,vid1,none,32902,32931,29
3949,vid1,none,32933,32962,29
3950,vid1,none,33820,33875,55
3951,vid1,none,33877,33932,55
3952,vid1,none,34829,34865,36
3953,vid1,none,34867,34903,36
3954,vid1,none,35585,35640,55
3956,vid1,none,36575,36630,55
3957,vid1,none,36632,36687,55
3961,vid1,none,40652,40707,55
3962,vid1,none,41397,41452,55
3963,vid1,none,41454,41509,55
3964,vid1,none,44616,44671,55
3965,vid1,none,44747,44802,55
3966,vid1,none,44804,44859,55
3967,vid1,none,46688,46736,48
3968,vid1,none,46738,46786,48
3969,vid1,none,46991,47046,55
3970,vid1,none,47048,47103,55
3971,vid1,none,47783,47831,48
3972,vid1,none,47890,47945,55
3973,vid1,none,47947,48002,55
3974,vid1,none,49397,49445,48
3975,vid1,none,49447,49495,48
3976,vid1,none,50796,50844,48
3977,vid1,none,50846,50894,48
3978,vid1,none,51001,51056,55
3979,vid1,none,51058,51113,55
3980,vid1,none,51334,51382,48
3981,vid1,none,51384,51432,48
3982,vid1,none,51825,51873,48
3984,vid1,none,52237,52292,55
3985,vid1,none,52294,52349,55
3987,vid1,none,54282,54311,29
3988,vid1,none,54705,54760,55
3990,vid2,none,734,782,48
3991,vid2,none,960,989,29
3992,vid2,none,991,1020,29
3993,vid2,none,1397,1452,55
3994,vid2,none,1454,1509,55
3995,vid2,none,2242,2290,48
3996,vid2,none,2292,2340,48
3997,vid2,none,2889,2944,55
3998,vid2,none,2946,3001,55
3999,vid2,none,3521,3576,55
4000,vid2,none,3578,3633,55
4001,vid2,none,8920,8975,55
4002,vid2,none,9034,9089,55
4003,vid2,none,9091,9146,55
4004,vid2,none,10189,10244,55
4005,vid2,none,10246,10301,55
4006,vid2,none,13320,13375,55
4007,vid2,none,13377,13432,55
4009,vid2,none,14359,14414,55
4010,vid2,none,15641,15696,55
4011,vid2,none,15698,15753,55
4012,vid2,none,16078,16133,55
4013,vid2,none,16224,16279,55
4014,vid2,none,16281,16336,55
4017,vid2,none,17272,17327,55
4018,vid2,none,17398,17453,55
4019,vid2,none,17455,17510,55
4021,vid2,none,17740,17769,29
4022,vid2,none,17946,18001,55
4023,vid2,none,18003,18058,55
4024,vid2,none,18339,18387,48
4025,vid2,none,18389,18437,48
4026,vid2,none,19188,19243,55
4027,vid2,none,19245,19300,55
4028,vid2,none,20491,20546,55
4029,vid2,none,20548,20603,55
4030,vid2,none,22697,22752,55
4031,vid2,none,22754,22809,55
4032,vid2,none,23387,23435,48
4033,vid2,none,23437,23485,48
4034,vid2,none,23683,23738,55
4035,vid2,none,23740,23795,55
4036,vid2,none,26345,26400,55
4037,vid2,none,26402,26457,55
4038,vid2,none,27791,27846,55
4039,vid2,none,27848,27903,55
4040,vid2,none,31987,32016,29
4041,vid2,none,32018,32047,29
4042,vid2,none,35228,35283,55
4043,vid2,none,35285,35340,55
4044,vid1,none,375,430,55
4045,vid1,none,432,487,55
4047,vid1,none,709,757,48
4048,vid1,none,1101,1156,55
4049,vid1,none,1158,1213,55
4050,vid1,none,1949,2004,55
4051,vid1,none,2006,2061,55
4052,vid1,none,2801,2856,55
4053,vid1,none,2858,2913,55
4054,vid1,none,3003,3039,36
4055,vid1,none,3041,3077,36
4056,vid1,none,3536,3591,55
4057,vid1,none,3977,4032,55
4058,vid1,none,4160,4208,48
4059,vid1,none,4210,4258,48
4060,vid1,none,4846,4901,55
4062,vid1,none,5481,5536,55
4063,vid1,none,5538,5593,55
4065,vid1,none,5760,5815,55
4066,vid1,none,5893,5941,48
4067,vid1,none,5943,5991,48
4069,vid1,none,6265,6320,55
4070,vid1,none,6322,6377,55
4071,vid1,none,6862,6917,55
4072,vid1,none,6970,7025,55
4073,vid1,none,7027,7082,55
4074,vid1,none,7162,7217,55
4075,vid1,none,7219,7274,55
4077,vid1,none,7563,7618,55
4078,vid1,none,7750,7805,55
4079,vid1,none,7807,7862,55
4080,vid1,none,8034,8089,55
4081,vid1,none,8243,8298,55
4082,vid1,none,8300,8355,55
4084,vid1,none,8429,8458,29
4085,vid1,none,8841,8877,36
4086,vid1,none,9160,9215,55
4088,vid1,none,10049,10104,55
4089,vid1,none,10106,10161,55
4090,vid1,none,10683,10738,55
4091,vid1,none,10740,10795,55
4092,vid1,none,12227,12282,55
4093,vid1,none,12284,12339,55
4094,vid1,none,12652,12707,55
4095,vid1,none,12709,12764,55
4096,vid1,none,13092,13147,55
4097,vid1,none,13223,13278,55
4098,vid1,none,13280,13335,55
4099,vid1,none,13509,13557,48
4101,vid1,none,13886,13941,55
4102,vid1,none,13943,13998,55
4103,vid1,none,14624,14679,55
4104,vid1,none,14681,14736,55
4105,vid1,none,15425,15480,55
4106,vid1,none,15482,15537,55
4108,vid1,none,16318,16373,55
4109,vid1,none,16375,16430,55
4113,vid1,none,17751,17806,55
4114,vid1,none,18529,18565,36
4115,vid1,none,18567,18603,36
4116,vid1,none,18732,18787,55
4117,vid1,none,18789,18844,55
4118,vid1,none,21229,21277,48
4119,vid1,none,21279,21327,48
4120,vid1,none,21395,21450,55
4121,vid1,none,21452,21507,55
4122,vid1,none,22191,22246,55
4123,vid1,none,22248,22303,55
4124,vid1,none,23273,23328,55
4125,vid1,none,23330,23385,55
4126,vid1,none,23641,23696,55
4127,vid1,none,23698,23753,55
4128,vid1,none,23817,23872,55
4129,vid1,none,23874,23929,55
4130,vid1,none,24008,24063,55
4131,vid1,none,24065,24120,55
4132,vid1,none,24255,24310,55
4133,vid1,none,24312,24367,55
4134,vid1,none,25712,25767,55
4135,vid1,none,25769,25824,55
4137,vid1,none,28649,28678,29
4139,vid1,none,30060,30115,55
4140,vid1,none,30994,31049,55
4141,vid1,none,31051,31106,55
4142,vid1,none,32774,32829,55
4143,vid1,none,32902,32931,29
4144,vid1,none,32933,32962,29
4145,vid1,none,33820,33875,55
4146,vid1,none,33877,33932,55
4148,vid1,none,34867,34903,36
4149,vid1,none,35585,35640,55
4150,vid1,none,35642,35697,55
4151,vid1,none,36575,36630,55
4152,vid1,none,36632,36687,55
4153,vid1,none,39878,39914,36
4154,vid1,none,39916,39952,36
4155,vid1,none,40595,40650,55
4156,vid1,none,40652,40707,55
4158,vid1,none,41454,41509,55
4159,vid1,none,44616,44671,55
4160,vid1,none,44747,44802,55
4161,vid1,none,44804,44859,55
4162,vid1,none,46688,46736,48
4163,vid1,none,46738,46786,48
4164,vid1,none,46991,47046,55
4165,vid1,none,47048,47103,55
4166,vid1,none,47783,47831,48
4168,vid1,none,47947,48002,55
4170,vid1,none,49447,49495,48
4171,vid1,none,50796,50844,48
4173,vid1,none,51001,51056,55
4174,vid1,none,51058,51113,55
4175,vid1,none,51334,51382,48
4176,vid1,none,51384,51432,48
4177,vid1,none,51825,51873,48
4178,vid1,none,51875,51923,48
4179,vid1,none,52237,52292,55
4180,vid1,none,52294,52349,55
4181,vid1,none,54251,54280,29
4183,vid1,none,54705,54760,55
4184,vid1,none,54762,54817,55
4185,vid2,none,734,782,48
4186,vid2,none,960,989,29
4187,vid2,none,991,1020,29
4188,vid2,none,1397,1452,55
4189,vid2,none,1454,1509,55
4191,vid2,none,2292,2340,48
4193,vid2,none,2946,3001,55
4194,vid2,none,3521,3576,55
4195,vid2,none,3578,3633,55
4196,vid2,none,8920,8975,55
4197,vid2,none,9034,9089,55
4198,vid2,none,9091,9146,55
4199,vid2,none,10189,10244,55
4201,vid2,none,13320,13375,55
4202,vid2,none,13377,13432,55
4203,vid2,none,14302,14357,55
4204,vid2,none,14359,14414,55
4205,vid2,none,15641,15696,55
4206,vid2,none,15698,15753,55
4208,vid2,none,16224,16279,55
4209,vid2,none,16281,16336,55
4210,vid2,none,17090,17119,29
4211,vid2,none,17121,17150,29
4213,vid2,none,17398,17453,55
4214,vid2,none,17455,17510,55
4215,vid2,none,17709,17738,29
4216,vid2,none,17740,17769,29
4217,vid2,none,17946,18001,55
4218,vid2,none,18003,18058,55
4219,vid2,none,18339,18387,48
4220,vid2,none,18389,18437,48
4221,vid2,none,19188,19243,55
4222,vid2,none,19245,19300,55
4223,vid2,none,20491,20546,55
4224,vid2,none,20548,20603,55
4225,vid2,none,22697,22752,55
4226,vid2,none,22754,22809,55
4227,vid2,none,23387,23435,48
4228,vid2,none,23437,23485,48
4229,vid2,none,23683,23738,55
4230,vid2,none,23740,23795,55
4231,vid2,none,26345,26400,55
4232,vid2,none,26402,26457,55
4234,vid2,none,27848,27903,55
4235,vid2,none,31987,32016,29
4236,vid2,none,32018,32047,29
4237,vid2,none,35228,35283,55
4238,vid2,none,35285,35340,55
